geoid,black,native,asian,PI,other,multi,hispanic,nonwhite,white,total,pct_nonwhite,pct_white,race_source_abbreviation,link_to_detailed_sourcing
1.00E+13,80,0,0,0,3,0,31,114,71,185,61.62162162,38.37837838,tract,http://www.prisonersofthecensus.org/data/2010blocks/010010202002008/
1.00E+13,190,0,1,0,1,0,4,196,292,488,40.16393443,59.83606557,tract_part,http://www.prisonersofthecensus.org/data/2010blocks/010030105001039/
1.00E+13,11,1,0,0,0,0,0,12,26,38,31.57894737,68.42105263,tract_part,http://www.prisonersofthecensus.org/data/2010blocks/010030108001027/
1.00E+13,10,0,0,0,0,0,0,10,7,17,58.82352941,41.17647059,tract_part,http://www.prisonersofthecensus.org/data/2010blocks/010030112012050/
1.00E+13,2,0,0,0,0,0,0,2,2,4,50,50,tract_part,http://www.prisonersofthecensus.org/data/2010blocks/010030114073034/
1.00E+13,300,1,0,0,0,0,1,302,203,505,59.8019802,40.1980198,tract_part,http://www.prisonersofthecensus.org/data/2010blocks/010030109033013/
1.01E+13,966,0,0,0,0,1,6,973,653,1626,59.8400984,40.1599016,institutionalized,http://www.prisonersofthecensus.org/data/2010blocks/010059502002082/
1.01E+13,43,0,0,0,0,0,0,43,55,98,43.87755102,56.12244898,institutionalized,http://www.prisonersofthecensus.org/data/2010blocks/010059502002091/
1.01E+13,785,0,0,0,0,39,17,841,492,1333,63.09077269,36.90922731,tract_part,http://www.prisonersofthecensus.org/data/2010blocks/010059504002044/
1.01E+13,1357,0,0,0,2,6,54,1419,595,2014,70.45680238,29.54319762,tract_part,http://www.prisonersofthecensus.org/data/2010blocks/010070100044013/
1.01E+13,6,0,0,0,1,0,5,12,118,130,9.230769231,90.76923077,tract_part,http://www.prisonersofthecensus.org/data/2010blocks/010090501011039/
1.01E+13,1,0,0,0,0,0,0,1,0,1,100,0,institutionalized,http://www.prisonersofthecensus.org/data/2010blocks/010119522003043/
1.01E+13,32,0,0,0,0,0,0,32,0,32,100,0,institutionalized,http://www.prisonersofthecensus.org/data/2010blocks/010119522003076/
1.01E+13,882,0,0,0,0,6,4,892,605,1497,59.58583834,40.41416166,tract_part,http://www.prisonersofthecensus.org/data/2010blocks/010119522001066/
1.01E+13,27,0,0,0,0,1,0,28,10,38,73.68421053,26.31578947,tract_part,http://www.prisonersofthecensus.org/data/2010blocks/010139531001000/
1.02E+13,162,0,5,0,0,0,14,181,228,409,44.25427873,55.74572127,tract_part,http://www.prisonersofthecensus.org/data/2010blocks/010150006001058/
1.02E+13,30,0,0,0,0,0,0,30,20,50,60,40,tract_part,http://www.prisonersofthecensus.org/data/2010blocks/010150008001014/
1.02E+13,2,0,0,0,0,0,0,2,6,8,25,75,tract_part,http://www.prisonersofthecensus.org/data/2010blocks/010150012012050/
1.02E+13,0,0,0,0,0,0,0,0,2,2,0,100,tract_part,http://www.prisonersofthecensus.org/data/2010blocks/010150022003003/
1.02E+13,62,0,0,0,0,0,1,63,74,137,45.98540146,54.01459854,tract_part,http://www.prisonersofthecensus.org/data/2010blocks/010179540004002/
1.02E+13,9,0,0,0,0,0,0,9,71,80,11.25,88.75,tract_part,http://www.prisonersofthecensus.org/data/2010blocks/010199560002036/
1.02E+13,51,0,0,0,1,0,44,96,83,179,53.63128492,46.36871508,tract_part,http://www.prisonersofthecensus.org/data/2010blocks/010210601014007/
1.02E+13,22,1,0,0,0,0,0,23,11,34,67.64705882,32.35294118,tract_part,http://www.prisonersofthecensus.org/data/2010blocks/010239568003028/
1.02E+13,0,0,0,0,0,0,0,0,2,2,0,100,tract_part,http://www.prisonersofthecensus.org/data/2010blocks/010239567002006/
1.03E+13,41,0,0,0,0,2,0,43,57,100,43,57,tract_part,http://www.prisonersofthecensus.org/data/2010blocks/010259578006003/
1.03E+13,24,0,0,0,1,0,3,28,49,77,36.36363636,63.63636364,tract_part,http://www.prisonersofthecensus.org/data/2010blocks/010279590003007/
1.03E+13,9,0,0,0,1,1,5,16,76,92,17.39130435,82.60869565,tract_part,http://www.prisonersofthecensus.org/data/2010blocks/010299596003003/
1.03E+13,138,1,0,0,0,1,2,142,100,242,58.67768595,41.32231405,tract_part,http://www.prisonersofthecensus.org/data/2010blocks/010310105001002/
1.03E+13,30,0,0,0,0,0,14,44,45,89,49.43820225,50.56179775,tract_part,http://www.prisonersofthecensus.org/data/2010blocks/010330205003033/
1.04E+13,19,0,0,0,0,0,0,19,26,45,42.22222222,57.77777778,tract_part,http://www.prisonersofthecensus.org/data/2010blocks/010359605002020/
1.04E+13,40,0,0,0,0,0,1,41,39,80,51.25,48.75,tract_part,http://www.prisonersofthecensus.org/data/2010blocks/010379612001019/
1.04E+13,58,0,0,0,0,0,1,59,113,172,34.30232558,65.69767442,tract_part,http://www.prisonersofthecensus.org/data/2010blocks/010399621002029/
1.04E+13,14,0,0,0,9,1,13,37,199,236,15.6779661,84.3220339,tract_part,http://www.prisonersofthecensus.org/data/2010blocks/010439650003020/
1.04E+13,0,0,0,0,14,1,27,42,32,74,56.75675676,43.24324324,tract_part,http://www.prisonersofthecensus.org/data/2010blocks/010439649002022/
1.04E+13,0,0,0,0,0,0,0,0,3,3,0,100,tract_part,http://www.prisonersofthecensus.org/data/2010blocks/010439654022063/
1.05E+13,4,0,0,0,0,0,0,4,5,9,44.44444444,55.55555556,tract_part,http://www.prisonersofthecensus.org/data/2010blocks/010450211022010/
1.05E+13,33,0,0,0,0,0,3,36,27,63,57.14285714,42.85714286,tract_part,http://www.prisonersofthecensus.org/data/2010blocks/010450207004001/
1.05E+13,19,0,0,0,0,0,16,35,163,198,17.67676768,82.32323232,tract_part,http://www.prisonersofthecensus.org/data/2010blocks/010499609003022/
1.05E+13,0,0,0,0,0,0,0,0,2,2,0,100,tract_part,http://www.prisonersofthecensus.org/data/2010blocks/010499611001081/
1.05E+13,0,0,0,0,0,1,0,1,3,4,25,75,tract_part,http://www.prisonersofthecensus.org/data/2010blocks/010499614001064/
1.05E+13,382,0,0,0,0,32,163,577,799,1376,41.93313953,58.06686047,institutionalized,http://www.prisonersofthecensus.org/data/2010blocks/010510301004084/
1.05E+13,1621,0,1,0,2,10,8,1642,763,2405,68.27442827,31.72557173,institutionalized,http://www.prisonersofthecensus.org/data/2010blocks/010510301004090/
1.05E+13,199,0,0,0,0,0,0,199,100,299,66.55518395,33.44481605,tract_part,http://www.prisonersofthecensus.org/data/2010blocks/010510309011013/
1.05E+13,306,8,1,0,0,11,15,341,377,718,47.49303621,52.50696379,institutionalized,http://www.prisonersofthecensus.org/data/2010blocks/010510306001015/
1.05E+13,96,1,0,0,0,4,2,103,138,241,42.73858921,57.26141079,institutionalized,http://www.prisonersofthecensus.org/data/2010blocks/010510306002079/
1.05E+13,79,0,0,0,0,0,6,85,78,163,52.14723926,47.85276074,tract_part,http://www.prisonersofthecensus.org/data/2010blocks/010539702002036/
1.05E+13,1200,13,3,0,1,31,20,1268,631,1899,66.77198526,33.22801474,institutionalized,http://www.prisonersofthecensus.org/data/2010blocks/010539704002037/
1.05E+13,705,0,2,0,0,2,3,712,288,1000,71.2,28.8,institutionalized,http://www.prisonersofthecensus.org/data/2010blocks/010539704002044/
1.06E+13,268,4,25,1,29,23,68,418,401,819,51.03785104,48.96214896,tract_part,http://www.prisonersofthecensus.org/data/2010blocks/010550012001012/
1.06E+13,0,0,0,0,0,0,0,0,10,10,0,100,tract_part,http://www.prisonersofthecensus.org/data/2010blocks/010570202004031/
1.06E+13,13,0,0,0,0,2,1,16,37,53,30.18867925,69.81132075,tract_part,http://www.prisonersofthecensus.org/data/2010blocks/010570203001064/
1.06E+13,2,0,0,0,0,0,1,3,7,10,30,70,tract_part,http://www.prisonersofthecensus.org/data/2010blocks/010599730003020/
1.06E+13,19,0,3,0,2,1,13,38,42,80,47.5,52.5,tract_part,http://www.prisonersofthecensus.org/data/2010blocks/010599733002027/
1.06E+13,19,0,0,0,0,0,3,22,32,54,40.74074074,59.25925926,tract_part,http://www.prisonersofthecensus.org/data/2010blocks/010610503003016/
1.07E+13,25,0,0,0,0,2,1,28,36,64,43.75,56.25,tract_part,http://www.prisonersofthecensus.org/data/2010blocks/010650404001002/
1.07E+13,56,0,0,0,0,0,0,56,47,103,54.36893204,45.63106796,tract_part,http://www.prisonersofthecensus.org/data/2010blocks/010650404005050/
1.07E+13,29,0,0,0,0,0,1,30,25,55,54.54545455,45.45454545,tract_part,http://www.prisonersofthecensus.org/data/2010blocks/010670302001069/
1.07E+13,59,0,0,0,0,0,0,59,32,91,64.83516484,35.16483516,institutionalized,http://www.prisonersofthecensus.org/data/2010blocks/010690406001029/
1.07E+13,63,0,0,0,0,1,1,65,49,114,57.01754386,42.98245614,institutionalized,http://www.prisonersofthecensus.org/data/2010blocks/010690406001035/
1.07E+13,192,0,0,0,0,0,8,200,148,348,57.47126437,42.52873563,tract,http://www.prisonersofthecensus.org/data/2010blocks/010690414002049/
1.07E+13,9,2,0,0,1,0,3,15,116,131,11.45038168,88.54961832,institutionalized,http://www.prisonersofthecensus.org/data/2010blocks/010719508004015/
1.07E+13,1,0,0,0,2,1,1,5,16,21,23.80952381,76.19047619,institutionalized,http://www.prisonersofthecensus.org/data/2010blocks/010719508004064/
1.07E+13,30,0,0,0,0,0,1,31,16,47,65.95744681,34.04255319,tract,http://www.prisonersofthecensus.org/data/2010blocks/010730102002154/
1.07E+13,107,0,0,0,0,0,3,110,171,281,39.14590747,60.85409253,tract,http://www.prisonersofthecensus.org/data/2010blocks/010730016001028/
1.07E+13,598,6,0,0,11,9,32,656,266,922,71.14967462,28.85032538,tract,http://www.prisonersofthecensus.org/data/2010blocks/010730027001062/
1.07E+13,120,0,1,0,2,7,6,136,23,159,85.53459119,14.46540881,tract,http://www.prisonersofthecensus.org/data/2010blocks/010730042003001/
1.07E+13,5,0,0,0,0,0,0,5,0,5,100,0,tract_part,http://www.prisonersofthecensus.org/data/2010blocks/010730106024021/
1.07E+13,13,0,0,0,0,0,1,14,4,18,77.77777778,22.22222222,tract_part,http://www.prisonersofthecensus.org/data/2010blocks/010730107021072/
1.07E+13,12,0,0,0,0,0,0,12,16,28,42.85714286,57.14285714,tract_part,http://www.prisonersofthecensus.org/data/2010blocks/010730100012028/
1.07E+13,0,0,0,0,0,0,0,0,1,1,0,100,tract_part,http://www.prisonersofthecensus.org/data/2010blocks/010730108012047/
1.07E+13,0,0,0,0,0,0,0,0,2,2,0,100,tract_part,http://www.prisonersofthecensus.org/data/2010blocks/010730123053017/
1.07E+13,3,0,0,0,0,0,0,3,4,7,42.85714286,57.14285714,tract_part,http://www.prisonersofthecensus.org/data/2010blocks/010730121043012/
1.07E+13,1,0,0,0,0,0,0,1,21,22,4.545454545,95.45454545,tract_part,http://www.prisonersofthecensus.org/data/2010blocks/010730111092024/
1.07E+13,0,0,0,0,0,0,0,0,4,4,0,100,tract_part,http://www.prisonersofthecensus.org/data/2010blocks/010730114002018/
1.07E+13,1150,1,1,1,0,1,0,1154,380,1534,75.22816167,24.77183833,tract_part,http://www.prisonersofthecensus.org/data/2010blocks/010730122002062/
1.08E+13,8,0,0,0,0,0,0,8,44,52,15.38461538,84.61538462,tract_part,http://www.prisonersofthecensus.org/data/2010blocks/010750301004040/
1.08E+13,40,0,0,0,0,0,10,50,95,145,34.48275862,65.51724138,tract_part,http://www.prisonersofthecensus.org/data/2010blocks/010770101001084/
1.08E+13,17,0,0,0,0,1,0,18,90,108,16.66666667,83.33333333,tract_part,http://www.prisonersofthecensus.org/data/2010blocks/010799794001001/
1.08E+13,183,0,0,0,0,0,20,203,128,331,61.32930514,38.67069486,tract_part,http://www.prisonersofthecensus.org/data/2010blocks/010810411004000/
1.08E+13,56,0,0,0,3,1,13,73,165,238,30.67226891,69.32773109,tract_part,http://www.prisonersofthecensus.org/data/2010blocks/010830206001053/
1.08E+13,1216,1,1,0,0,1,9,1228,1116,2344,52.3890785,47.6109215,tract_part,http://www.prisonersofthecensus.org/data/2010blocks/010830208013001/
1.09E+13,33,0,0,0,0,0,0,33,1,34,97.05882353,2.941176471,tract_part,http://www.prisonersofthecensus.org/data/2010blocks/010857808002036/
1.09E+13,49,0,0,0,0,0,0,49,2,51,96.07843137,3.921568627,tract_part,http://www.prisonersofthecensus.org/data/2010blocks/010872323001029/
1.09E+13,84,0,1,0,10,7,20,122,50,172,70.93023256,29.06976744,institutionalized,http://www.prisonersofthecensus.org/data/2010blocks/010890031001052/
1.09E+13,445,10,2,1,1,9,54,522,343,865,60.34682081,39.65317919,institutionalized,http://www.prisonersofthecensus.org/data/2010blocks/010890031002025/
1.09E+13,55,0,0,0,0,2,2,59,11,70,84.28571429,15.71428571,tract_part,http://www.prisonersofthecensus.org/data/2010blocks/010919730006030/
1.09E+13,140,0,0,0,0,0,0,140,124,264,53.03030303,46.96969697,institutionalized,http://www.prisonersofthecensus.org/data/2010blocks/010939644001025/
1.09E+13,104,0,0,0,0,0,0,104,189,293,35.49488055,64.50511945,institutionalized,http://www.prisonersofthecensus.org/data/2010blocks/010939644003051/
1.10E+13,4,0,0,0,0,0,1,5,59,64,7.8125,92.1875,institutionalized,http://www.prisonersofthecensus.org/data/2010blocks/010950309032037/
1.10E+13,2,0,0,0,0,0,1,3,27,30,10,90,institutionalized,http://www.prisonersofthecensus.org/data/2010blocks/010950309032052/
1.10E+13,1,0,0,0,0,0,0,1,12,13,7.692307692,92.30769231,tract_part,http://www.prisonersofthecensus.org/data/2010blocks/010950311004020/
1.10E+13,0,0,0,0,0,0,0,0,14,14,0,100,tract_part,http://www.prisonersofthecensus.org/data/2010blocks/010950304015038/
1.10E+13,18,0,0,0,2,0,4,24,178,202,11.88118812,88.11881188,institutionalized,http://www.prisonersofthecensus.org/data/2010blocks/010950307021007/
1.10E+13,1,0,0,0,0,0,1,2,12,14,14.28571429,85.71428571,institutionalized,http://www.prisonersofthecensus.org/data/2010blocks/010950307021021/
1.10E+13,4,0,0,0,0,0,0,4,1,5,80,20,tract_part,http://www.prisonersofthecensus.org/data/2010blocks/010970052001012/
1.10E+13,639,1,3,0,2,0,6,651,339,990,65.75757576,34.24242424,institutionalized,http://www.prisonersofthecensus.org/data/2010blocks/010970012001441/
1.10E+13,213,0,0,0,0,1,1,215,112,327,65.74923547,34.25076453,institutionalized,http://www.prisonersofthecensus.org/data/2010blocks/010970012001451/
1.10E+13,1,0,0,0,0,0,0,1,7,8,12.5,87.5,tract_part,http://www.prisonersofthecensus.org/data/2010blocks/010970054001040/
1.10E+13,44,0,0,0,0,0,0,44,11,55,80,20,tract_part,http://www.prisonersofthecensus.org/data/2010blocks/010990760003037/
1.10E+13,274,0,0,0,0,0,18,292,33,325,89.84615385,10.15384615,tract,http://www.prisonersofthecensus.org/data/2010blocks/011010001001017/
1.10E+13,406,1,0,0,1,0,7,415,96,511,81.21330724,18.78669276,tract,http://www.prisonersofthecensus.org/data/2010blocks/011010002001021/
1.10E+13,504,0,0,0,0,2,38,544,370,914,59.51859956,40.48140044,tract,http://www.prisonersofthecensus.org/data/2010blocks/011010009001000/
1.10E+13,216,0,0,0,0,0,1,217,107,324,66.97530864,33.02469136,tract_part,http://www.prisonersofthecensus.org/data/2010blocks/011010051011010/
1.10E+13,865,0,1,0,0,1,28,895,796,1691,52.92726198,47.07273802,tract_part,http://www.prisonersofthecensus.org/data/2010blocks/011010055012026/
1.10E+13,126,0,0,0,0,0,1,127,237,364,34.89010989,65.10989011,institutionalized,http://www.prisonersofthecensus.org/data/2010blocks/011030004001006/
1.10E+13,57,0,0,0,0,0,66,123,34,157,78.34394904,21.65605096,institutionalized,http://www.prisonersofthecensus.org/data/2010blocks/011030004004074/
1.10E+13,402,0,0,0,0,0,4,406,308,714,56.8627451,43.1372549,tract_part,http://www.prisonersofthecensus.org/data/2010blocks/011030006001101/
1.11E+13,16,0,0,0,0,0,0,16,1,17,94.11764706,5.882352941,tract_part,http://www.prisonersofthecensus.org/data/2010blocks/011056870001043/
1.11E+13,46,1,0,0,19,1,58,125,67,192,65.10416667,34.89583333,tract_part,http://www.prisonersofthecensus.org/data/2010blocks/011070503002035/
1.11E+13,2,0,0,0,0,0,0,2,0,2,100,0,tract_part,http://www.prisonersofthecensus.org/data/2010blocks/011091889003035/
1.11E+13,25,0,0,0,0,0,1,26,22,48,54.16666667,45.83333333,tract_part,http://www.prisonersofthecensus.org/data/2010blocks/011110003002011/
1.11E+13,136,0,0,0,0,7,1,144,148,292,49.31506849,50.68493151,tract_part,http://www.prisonersofthecensus.org/data/2010blocks/011130306002005/
1.12E+13,12,0,0,0,0,0,2,14,72,86,16.27906977,83.72093023,tract_part,http://www.prisonersofthecensus.org/data/2010blocks/011150404012011/
1.12E+13,37,0,0,0,0,0,1,38,88,126,30.15873016,69.84126984,tract_part,http://www.prisonersofthecensus.org/data/2010blocks/011150402032005/
1.12E+13,970,0,1,0,0,2,19,992,439,1431,69.32215234,30.67784766,tract_part,http://www.prisonersofthecensus.org/data/2010blocks/011150405023009/
1.12E+13,1,0,0,0,0,0,0,1,3,4,25,75,tract,http://www.prisonersofthecensus.org/data/2010blocks/011170303192002/
1.12E+13,16,0,0,0,0,0,2,18,14,32,56.25,43.75,tract_part,http://www.prisonersofthecensus.org/data/2010blocks/011170303142041/
1.12E+13,1,0,0,0,0,0,0,1,1,2,50,50,tract_part,http://www.prisonersofthecensus.org/data/2010blocks/011170303152032/
1.12E+13,410,1,1,0,22,4,34,472,393,865,54.56647399,45.43352601,tract_part,http://www.prisonersofthecensus.org/data/2010blocks/011170307011110/
1.12E+13,369,0,0,0,0,5,10,384,164,548,70.0729927,29.9270073,tract_part,http://www.prisonersofthecensus.org/data/2010blocks/011210112001153/
1.12E+13,102,1,0,0,3,2,8,116,117,233,49.78540773,50.21459227,institutionalized,http://www.prisonersofthecensus.org/data/2010blocks/011210107001029/
1.12E+13,423,22,1,0,100,38,248,832,167,999,83.28328328,16.71671672,institutionalized,http://www.prisonersofthecensus.org/data/2010blocks/011210107001034/
1.12E+13,179,3,2,0,12,5,51,252,120,372,67.74193548,32.25806452,tract_part,http://www.prisonersofthecensus.org/data/2010blocks/011210103012068/
1.12E+13,88,0,0,0,1,0,1,90,48,138,65.2173913,34.7826087,tract_part,http://www.prisonersofthecensus.org/data/2010blocks/011239624003033/
1.13E+13,366,0,0,0,2,1,10,379,240,619,61.22778675,38.77221325,tract_part,http://www.prisonersofthecensus.org/data/2010blocks/011250116001154/
1.13E+13,0,0,0,0,0,0,0,0,2,2,0,100,tract_part,http://www.prisonersofthecensus.org/data/2010blocks/011270218002028/
1.13E+13,76,0,0,0,21,1,43,141,128,269,52.41635688,47.58364312,tract_part,http://www.prisonersofthecensus.org/data/2010blocks/011270202002083/
1.13E+13,0,0,0,0,0,0,0,0,22,22,0,100,institutionalized,http://www.prisonersofthecensus.org/data/2010blocks/011270203004034/
1.13E+13,5,0,0,0,1,0,1,7,34,41,17.07317073,82.92682927,institutionalized,http://www.prisonersofthecensus.org/data/2010blocks/011270203004042/
1.13E+13,23,0,0,0,0,0,0,23,44,67,34.32835821,65.67164179,tract_part,http://www.prisonersofthecensus.org/data/2010blocks/011290440004054/
1.13E+13,26,0,0,0,0,1,1,28,10,38,73.68421053,26.31578947,tract_part,http://www.prisonersofthecensus.org/data/2010blocks/011310352002000/
1.13E+13,0,0,1,0,0,1,0,2,54,56,3.571428571,96.42857143,tract_part,http://www.prisonersofthecensus.org/data/2010blocks/011339656004039/
2.02E+13,0,0,0,0,0,0,0,0,1,1,0,100,remaining,http://www.prisonersofthecensus.org/data/2010blocks/020160002001050/
2.02E+13,0,0,0,0,1,0,1,2,0,2,100,0,institutionalized,http://www.prisonersofthecensus.org/data/2010blocks/020160002002009/
2.02E+13,20,123,4,8,1,55,33,244,168,412,59.22330097,40.77669903,tract,http://www.prisonersofthecensus.org/data/2010blocks/020200002042036/
2.02E+13,70,191,14,9,8,60,34,386,255,641,60.21840874,39.78159126,tract,http://www.prisonersofthecensus.org/data/2010blocks/020200009011008/
2.02E+13,10,40,0,1,3,4,11,69,36,105,65.71428571,34.28571429,institutionalized,http://www.prisonersofthecensus.org/data/2010blocks/020200011002004/
2.02E+13,4,26,0,0,1,5,5,41,52,93,44.08602151,55.91397849,institutionalized,http://www.prisonersofthecensus.org/data/2010blocks/020200011002036/
2.02E+13,3,7,1,2,0,2,1,16,11,27,59.25925926,40.74074074,institutionalized,http://www.prisonersofthecensus.org/data/2010blocks/020200011002038/
2.02E+13,3,12,1,0,0,2,3,21,12,33,63.63636364,36.36363636,tract,http://www.prisonersofthecensus.org/data/2010blocks/020200014006009/
2.02E+13,9,39,1,4,2,33,12,100,37,137,72.99270073,27.00729927,tract,http://www.prisonersofthecensus.org/data/2010blocks/020200016021014/
2.05E+13,0,77,0,0,0,1,0,78,2,80,97.5,2.5,institutionalized,http://www.prisonersofthecensus.org/data/2010blocks/020500002002000/
2.05E+13,0,78,1,0,0,1,0,80,1,81,98.7654321,1.234567901,remaining,http://www.prisonersofthecensus.org/data/2010blocks/020500002002004/
2.09E+13,1,0,0,0,0,0,0,1,0,1,100,0,tract_part,http://www.prisonersofthecensus.org/data/2010blocks/020900007003027/
2.09E+13,16,44,2,0,0,8,3,73,53,126,57.93650794,42.06349206,tract_part,http://www.prisonersofthecensus.org/data/2010blocks/020900019005048/
2.09E+13,40,127,0,1,0,2,8,178,124,302,58.94039735,41.05960265,tract,http://www.prisonersofthecensus.org/data/2010blocks/020900002002027/
2.11E+13,7,84,3,1,1,18,16,130,87,217,59.9078341,40.0921659,institutionalized,http://www.prisonersofthecensus.org/data/2010blocks/021100004002001/
2.11E+13,2,40,1,0,0,11,5,59,43,102,57.84313725,42.15686275,institutionalized,http://www.prisonersofthecensus.org/data/2010blocks/021100004003003/
2.12E+13,9,124,9,3,4,36,24,209,201,410,50.97560976,49.02439024,tract_part,http://www.prisonersofthecensus.org/data/2010blocks/021220002004035/
2.12E+13,59,201,1,12,4,51,43,371,204,575,64.52173913,35.47826087,tract_part,http://www.prisonersofthecensus.org/data/2010blocks/021220013002000/
2.13E+13,0,34,0,0,1,4,3,42,28,70,60,40,tract_part,http://www.prisonersofthecensus.org/data/2010blocks/021300003001007/
2.17E+13,5,18,0,0,1,13,7,44,102,146,30.1369863,69.8630137,tract_part,http://www.prisonersofthecensus.org/data/2010blocks/021700012012010/
2.17E+13,11,45,1,2,2,8,9,78,53,131,59.54198473,40.45801527,tract_part,http://www.prisonersofthecensus.org/data/2010blocks/021700006042050/
2.17E+13,31,144,5,6,2,72,35,295,209,504,58.53174603,41.46825397,tract_part,http://www.prisonersofthecensus.org/data/2010blocks/021700002001003/
2.18E+13,1,84,0,0,0,3,2,90,2,92,97.82608696,2.173913043,institutionalized,http://www.prisonersofthecensus.org/data/2010blocks/021800002002006/
2.18E+13,0,31,0,0,0,1,0,32,0,32,100,0,institutionalized,http://www.prisonersofthecensus.org/data/2010blocks/021800002003026/
2.19E+13,0,8,0,0,0,0,0,8,0,8,100,0,tract_part,http://www.prisonersofthecensus.org/data/2010blocks/021880002002010/
2.22E+13,0,1,0,0,0,0,0,1,2,3,33.33333333,66.66666667,tract_part,http://www.prisonersofthecensus.org/data/2010blocks/022200002004032/
2.26E+13,0,1,0,0,0,0,0,1,1,2,50,50,tract_part,http://www.prisonersofthecensus.org/data/2010blocks/022610003003003/
4.00E+13,1,14,0,0,0,1,57,73,23,96,76.04166667,23.95833333,tract_part,http://www.prisonersofthecensus.org/data/2010blocks/040019703002029/
4.00E+13,43,9,0,0,0,5,116,173,166,339,51.03244838,48.96755162,tract_part,http://www.prisonersofthecensus.org/data/2010blocks/040019703001350/
4.00E+13,23,8,2,1,41,10,96,181,73,254,71.25984252,28.74015748,tract_part,http://www.prisonersofthecensus.org/data/2010blocks/040030010001066/
4.00E+13,42,15,0,0,94,1,95,247,124,371,66.57681941,33.42318059,tract_part,http://www.prisonersofthecensus.org/data/2010blocks/040030007004014/
4.00E+13,329,136,10,3,524,29,811,1842,898,2740,67.22627737,32.77372263,tract_part,http://www.prisonersofthecensus.org/data/2010blocks/040030005004039/
4.00E+13,20,10,2,0,30,5,66,133,35,168,79.16666667,20.83333333,tract_part,http://www.prisonersofthecensus.org/data/2010blocks/040030005004036/
4.00E+13,0,0,0,0,1,0,1,2,3,5,40,60,tract_part,http://www.prisonersofthecensus.org/data/2010blocks/040030002022033/
4.01E+13,12,228,3,0,0,1,87,331,191,522,63.40996169,36.59003831,institutionalized,http://www.prisonersofthecensus.org/data/2010blocks/040050008003064/
4.01E+13,1,10,0,0,0,3,9,23,7,30,76.66666667,23.33333333,institutionalized,http://www.prisonersofthecensus.org/data/2010blocks/040050008003073/
4.01E+13,0,0,1,0,0,0,1,2,2,4,50,50,institutionalized,http://www.prisonersofthecensus.org/data/2010blocks/040050010001017/
4.01E+13,0,1,0,0,0,0,0,1,0,1,100,0,institutionalized,http://www.prisonersofthecensus.org/data/2010blocks/040050010002028/
4.01E+13,27,13,0,0,27,0,109,176,115,291,60.48109966,39.51890034,tract_part,http://www.prisonersofthecensus.org/data/2010blocks/040070012001003/
4.01E+13,0,11,0,0,9,3,36,59,69,128,46.09375,53.90625,tract_part,http://www.prisonersofthecensus.org/data/2010blocks/040070012002006/
4.01E+13,0,2,0,0,0,0,3,5,7,12,41.66666667,58.33333333,tract,http://www.prisonersofthecensus.org/data/2010blocks/040070003012043/
4.01E+13,162,125,33,20,203,77,683,1303,274,1577,82.62523779,17.37476221,tract_part,http://www.prisonersofthecensus.org/data/2010blocks/040099616003009/
4.01E+13,105,34,4,1,0,0,425,569,343,912,62.39035088,37.60964912,tract_part,http://www.prisonersofthecensus.org/data/2010blocks/040099616002013/
4.01E+13,2,4,0,0,0,1,95,102,29,131,77.86259542,22.13740458,tract,http://www.prisonersofthecensus.org/data/2010blocks/040099613002012/
4.01E+13,7,3,0,1,0,0,45,56,22,78,71.79487179,28.20512821,institutionalized,http://www.prisonersofthecensus.org/data/2010blocks/040099617001100/
4.01E+13,110,28,7,1,4,1,513,664,278,942,70.48832272,29.51167728,institutionalized,http://www.prisonersofthecensus.org/data/2010blocks/040099617001107/
4.01E+13,1,0,0,0,0,0,10,11,22,33,33.33333333,66.66666667,tract_part,http://www.prisonersofthecensus.org/data/2010blocks/040119601001335/
4.01E+13,1,1,0,0,20,2,143,167,49,216,77.31481481,22.68518519,tract,http://www.prisonersofthecensus.org/data/2010blocks/040129402001105/
4.01E+13,0,38,0,0,0,0,4,42,0,42,100,0,tract_part,http://www.prisonersofthecensus.org/data/2010blocks/040129403004011/
4.01E+13,0,0,0,0,0,0,0,0,2,2,0,100,tract,http://www.prisonersofthecensus.org/data/2010blocks/040135230031005/
4.01E+13,190,113,14,7,255,62,506,1147,299,1446,79.32226833,20.67773167,tract_part,http://www.prisonersofthecensus.org/data/2010blocks/040136100002034/
4.01E+13,696,288,30,6,1625,52,2093,4790,1997,6787,70.57610137,29.42389863,tract_part,http://www.prisonersofthecensus.org/data/2010blocks/040137233061092/
4.01E+13,0,0,0,0,0,0,0,0,2,2,0,100,tract_part,http://www.prisonersofthecensus.org/data/2010blocks/040130611001026/
4.01E+13,262,181,14,0,393,63,812,1725,954,2679,64.38969765,35.61030235,institutionalized,http://www.prisonersofthecensus.org/data/2010blocks/040130610171001/
4.01E+13,114,108,8,0,180,31,453,894,629,1523,58.69993434,41.30006566,institutionalized,http://www.prisonersofthecensus.org/data/2010blocks/040130610171002/
4.01E+13,0,0,0,0,0,0,0,0,3,3,0,100,tract,http://www.prisonersofthecensus.org/data/2010blocks/040134202103008/
4.01E+13,3,0,0,0,0,0,0,3,0,3,100,0,tract,http://www.prisonersofthecensus.org/data/2010blocks/040134211025017/
4.01E+13,0,0,0,0,0,0,0,0,5,5,0,100,tract,http://www.prisonersofthecensus.org/data/2010blocks/040134213021016/
4.01E+13,2,0,0,0,0,0,0,2,5,7,28.57142857,71.42857143,tract,http://www.prisonersofthecensus.org/data/2010blocks/040134215022001/
4.01E+13,0,0,0,0,0,0,0,0,5,5,0,100,tract,http://www.prisonersofthecensus.org/data/2010blocks/040134216012016/
4.01E+13,0,0,0,0,0,0,0,0,3,3,0,100,tract,http://www.prisonersofthecensus.org/data/2010blocks/040134226372016/
4.01E+13,0,0,0,0,0,0,0,0,2,2,0,100,tract_part,http://www.prisonersofthecensus.org/data/2010blocks/040131032201015/
4.01E+13,0,0,2,0,0,4,0,6,0,6,100,0,tract,http://www.prisonersofthecensus.org/data/2010blocks/040131036041010/
4.01E+13,0,0,0,0,0,0,0,0,1,1,0,100,tract,http://www.prisonersofthecensus.org/data/2010blocks/040131080002007/
4.01E+13,0,0,0,0,3,1,7,11,0,11,100,0,tract,http://www.prisonersofthecensus.org/data/2010blocks/040131115011012/
4.01E+13,0,0,0,0,0,0,0,0,5,5,0,100,tract,http://www.prisonersofthecensus.org/data/2010blocks/040131115021002/
4.01E+13,57,19,1,0,129,1,148,355,196,551,64.42831216,35.57168784,tract,http://www.prisonersofthecensus.org/data/2010blocks/040131134001007/
4.01E+13,0,11,0,0,0,0,4,15,10,25,60,40,institutionalized,http://www.prisonersofthecensus.org/data/2010blocks/040131135011013/
4.01E+13,4,11,0,0,10,4,22,51,22,73,69.8630137,30.1369863,institutionalized,http://www.prisonersofthecensus.org/data/2010blocks/040131135011016/
4.01E+13,395,74,12,0,349,6,760,1596,546,2142,74.50980392,25.49019608,tract,http://www.prisonersofthecensus.org/data/2010blocks/040131141001052/
4.01E+13,28,85,2,1,109,11,213,449,176,625,71.84,28.16,institutionalized,http://www.prisonersofthecensus.org/data/2010blocks/040131147031007/
4.01E+13,599,218,26,1,848,90,1819,3601,1687,5288,68.09757943,31.90242057,institutionalized,http://www.prisonersofthecensus.org/data/2010blocks/040131147032001/
4.01E+13,186,52,4,0,572,63,1099,1976,508,2484,79.54911433,20.45088567,institutionalized,http://www.prisonersofthecensus.org/data/2010blocks/040131147032005/
4.01E+13,0,0,0,0,0,0,0,0,2,2,0,100,tract,http://www.prisonersofthecensus.org/data/2010blocks/040132168391010/
4.01E+13,4,22,0,0,16,7,33,82,21,103,79.61165049,20.38834951,tract_part,http://www.prisonersofthecensus.org/data/2010blocks/040130405022009/
4.02E+13,217,71,6,0,190,86,661,1231,542,1773,69.43034405,30.56965595,tract_part,http://www.prisonersofthecensus.org/data/2010blocks/040159548001638/
4.02E+13,0,2,3,0,8,1,27,41,89,130,31.53846154,68.46153846,institutionalized,http://www.prisonersofthecensus.org/data/2010blocks/040159536021034/
4.02E+13,11,11,1,0,14,4,39,80,198,278,28.77697842,71.22302158,institutionalized,http://www.prisonersofthecensus.org/data/2010blocks/040159536022034/
4.02E+13,0,0,0,0,0,0,3,3,3,6,50,50,institutionalized,http://www.prisonersofthecensus.org/data/2010blocks/040159536022075/
4.02E+13,0,32,0,0,0,0,0,32,0,32,100,0,tract_part,http://www.prisonersofthecensus.org/data/2010blocks/040159404001203/
4.02E+13,0,0,0,0,0,0,2,2,14,16,12.5,87.5,tract_part,http://www.prisonersofthecensus.org/data/2010blocks/040159525001050/
4.02E+13,6,69,0,0,10,4,117,206,111,317,64.98422713,35.01577287,tract_part,http://www.prisonersofthecensus.org/data/2010blocks/040179602001147/
4.02E+13,232,54,16,0,0,8,713,1023,397,1420,72.04225352,27.95774648,tract_part,http://www.prisonersofthecensus.org/data/2010blocks/040179605002163/
4.02E+13,0,3,0,0,2,0,2,7,1,8,87.5,12.5,tract_part,http://www.prisonersofthecensus.org/data/2010blocks/040194704003033/
4.02E+13,42,22,0,0,160,29,247,500,189,689,72.56894049,27.43105951,tract_part,http://www.prisonersofthecensus.org/data/2010blocks/040190044301011/
4.02E+13,0,132,0,0,0,0,0,132,1,133,99.2481203,0.751879699,tract_part,http://www.prisonersofthecensus.org/data/2010blocks/040199408001014/
4.02E+13,0,0,0,0,0,0,3,3,0,3,100,0,tract,http://www.prisonersofthecensus.org/data/2010blocks/040190046171010/
4.02E+13,2,26,0,0,12,0,23,63,14,77,81.81818182,18.18181818,tract,http://www.prisonersofthecensus.org/data/2010blocks/040190013033008/
4.02E+13,47,44,5,0,116,7,193,412,299,711,57.94655415,42.05344585,institutionalized,http://www.prisonersofthecensus.org/data/2010blocks/040190025014010/
4.02E+13,147,101,9,3,321,62,655,1298,422,1720,75.46511628,24.53488372,institutionalized,http://www.prisonersofthecensus.org/data/2010blocks/040190025014013/
4.02E+13,1,16,0,0,0,0,18,35,7,42,83.33333333,16.66666667,tract,http://www.prisonersofthecensus.org/data/2010blocks/040190037022019/
4.02E+13,0,0,0,0,0,0,0,0,2,2,0,100,tract,http://www.prisonersofthecensus.org/data/2010blocks/040190040293004/
4.02E+13,0,0,5,0,0,0,0,5,0,5,100,0,tract,http://www.prisonersofthecensus.org/data/2010blocks/040190040693004/
4.02E+13,720,197,27,2,396,152,1357,2851,1836,4687,60.82782163,39.17217837,tract,http://www.prisonersofthecensus.org/data/2010blocks/040190041131000/
4.02E+13,319,29,6,7,0,31,187,579,377,956,60.56485356,39.43514644,tract_part,http://www.prisonersofthecensus.org/data/2010blocks/040194105021158/
4.02E+13,50,40,1,2,55,85,423,656,69,725,90.48275862,9.517241379,tract_part,http://www.prisonersofthecensus.org/data/2010blocks/040194105031042/
4.02E+13,10,5,0,2,0,17,50,84,34,118,71.18644068,28.81355932,tract_part,http://www.prisonersofthecensus.org/data/2010blocks/040194105021147/
4.02E+13,1103,85,347,37,2607,51,3078,7308,750,8058,90.69247952,9.307520477,institutionalized,http://www.prisonersofthecensus.org/data/2010blocks/040210020022000/
4.02E+13,95,23,360,908,57,24,177,1644,332,1976,83.19838057,16.80161943,institutionalized,http://www.prisonersofthecensus.org/data/2010blocks/040210020022002/
4.02E+13,27,8,0,0,38,2,51,126,99,225,56,44,tract_part,http://www.prisonersofthecensus.org/data/2010blocks/040210021022064/
4.02E+13,380,1197,24,6,988,96,1534,4225,2222,6447,65.53435707,34.46564293,institutionalized,http://www.prisonersofthecensus.org/data/2010blocks/040210008031059/
4.02E+13,79,78,4,1,126,12,224,524,361,885,59.20903955,40.79096045,institutionalized,http://www.prisonersofthecensus.org/data/2010blocks/040210008032028/
4.02E+13,366,902,16,5,595,82,1083,3049,1562,4611,66.12448493,33.87551507,institutionalized,http://www.prisonersofthecensus.org/data/2010blocks/040210008032035/
4.02E+13,103,90,10,1,185,28,332,749,716,1465,51.12627986,48.87372014,institutionalized,http://www.prisonersofthecensus.org/data/2010blocks/040210008032038/
4.02E+13,76,41,35,2,106,12,1414,1686,142,1828,92.23194748,7.768052516,institutionalized,http://www.prisonersofthecensus.org/data/2010blocks/040210009012001/
4.02E+13,285,1195,64,2,803,81,1512,3942,1462,5404,72.94596595,27.05403405,institutionalized,http://www.prisonersofthecensus.org/data/2010blocks/040210009012002/
4.02E+13,3,31,0,0,3,1,9,47,11,58,81.03448276,18.96551724,institutionalized,http://www.prisonersofthecensus.org/data/2010blocks/040210009012005/
4.02E+13,0,89,0,0,0,3,10,102,0,102,100,0,tract_part,http://www.prisonersofthecensus.org/data/2010blocks/040219412002113/
4.02E+13,0,8,0,0,0,0,0,8,0,8,100,0,tract_part,http://www.prisonersofthecensus.org/data/2010blocks/040219414003044/
4.02E+13,2,0,0,0,0,0,44,46,3,49,93.87755102,6.12244898,tract,http://www.prisonersofthecensus.org/data/2010blocks/040239663021014/
4.03E+13,11,25,2,0,0,1,205,244,292,536,45.52238806,54.47761194,tract_part,http://www.prisonersofthecensus.org/data/2010blocks/040250016012012/
4.03E+13,0,2,0,0,0,0,1,3,7,10,30,70,tract_part,http://www.prisonersofthecensus.org/data/2010blocks/040250020011033/
4.03E+13,1,1,0,0,0,0,0,2,4,6,33.33333333,66.66666667,tract_part,http://www.prisonersofthecensus.org/data/2010blocks/040250020041067/
4.03E+13,15,8,1,0,114,53,432,623,51,674,92.43323442,7.566765579,tract_part,http://www.prisonersofthecensus.org/data/2010blocks/040279800051007/
4.03E+13,420,179,13,9,351,117,1075,2164,754,2918,74.16038382,25.83961618,tract_part,http://www.prisonersofthecensus.org/data/2010blocks/040270118001038/
4.03E+13,50,35,6,0,177,14,259,541,224,765,70.71895425,29.28104575,tract_part,http://www.prisonersofthecensus.org/data/2010blocks/040270001001020/
5.00E+13,46,0,0,0,0,0,0,46,34,80,57.5,42.5,tract_part,http://www.prisonersofthecensus.org/data/2010blocks/050014806002073/
5.00E+13,50,2,0,0,0,1,4,57,26,83,68.6746988,31.3253012,tract_part,http://www.prisonersofthecensus.org/data/2010blocks/050039603003006/
5.01E+13,0,0,0,0,0,0,0,0,51,51,0,100,tract_part,http://www.prisonersofthecensus.org/data/2010blocks/050059504002075/
5.01E+13,2,7,0,0,1,3,1,14,33,47,29.78723404,70.21276596,tract_part,http://www.prisonersofthecensus.org/data/2010blocks/050070210021031/
5.01E+13,4,1,0,0,0,0,2,7,65,72,9.722222222,90.27777778,tract_part,http://www.prisonersofthecensus.org/data/2010blocks/050097903002000/
5.01E+13,0,0,0,0,37,0,53,90,0,90,100,0,tract_part,http://www.prisonersofthecensus.org/data/2010blocks/050119505001040/
5.01E+13,12,0,0,0,0,1,0,13,14,27,48.14814815,51.85185185,tract_part,http://www.prisonersofthecensus.org/data/2010blocks/050134802002009/
5.02E+13,6,1,0,0,0,1,12,20,75,95,21.05263158,78.94736842,tract_part,http://www.prisonersofthecensus.org/data/2010blocks/050159503003005/
5.02E+13,4,0,0,0,0,0,0,4,1,5,80,20,tract_part,http://www.prisonersofthecensus.org/data/2010blocks/050170802001075/
5.02E+13,324,1,1,0,6,0,11,343,236,579,59.24006908,40.75993092,tract_part,http://www.prisonersofthecensus.org/data/2010blocks/050170801001128/
5.02E+13,29,0,0,0,0,0,1,30,13,43,69.76744186,30.23255814,tract_part,http://www.prisonersofthecensus.org/data/2010blocks/050199538001009/
5.02E+13,11,0,0,0,2,1,3,17,56,73,23.28767123,76.71232877,tract_part,http://www.prisonersofthecensus.org/data/2010blocks/050219506003004/
5.02E+13,2,0,0,0,0,0,0,2,78,80,2.5,97.5,tract_part,http://www.prisonersofthecensus.org/data/2010blocks/050234804004007/
5.03E+13,35,0,0,0,0,0,0,35,19,54,64.81481481,35.18518519,tract_part,http://www.prisonersofthecensus.org/data/2010blocks/050279505001019/
5.03E+13,1,0,0,0,0,0,0,1,0,1,100,0,tract_part,http://www.prisonersofthecensus.org/data/2010blocks/050299503002104/
5.03E+13,30,0,0,0,1,0,1,32,77,109,29.35779817,70.64220183,tract_part,http://www.prisonersofthecensus.org/data/2010blocks/050310004022012/
5.03E+13,125,0,0,0,0,0,10,135,195,330,40.90909091,59.09090909,tract_part,http://www.prisonersofthecensus.org/data/2010blocks/050310007005047/
5.03E+13,13,1,2,0,2,0,6,24,96,120,20,80,tract_part,http://www.prisonersofthecensus.org/data/2010blocks/050330205023065/
5.04E+13,213,0,0,0,1,0,2,216,84,300,72,28,tract_part,http://www.prisonersofthecensus.org/data/2010blocks/050350307031130/
5.04E+13,20,1,0,0,0,0,0,21,33,54,38.88888889,61.11111111,tract_part,http://www.prisonersofthecensus.org/data/2010blocks/050379506001010/
5.04E+13,46,0,0,0,0,1,33,80,59,139,57.55395683,42.44604317,tract_part,http://www.prisonersofthecensus.org/data/2010blocks/050399703005030/
5.04E+13,23,0,0,0,0,0,2,25,11,36,69.44444444,30.55555556,tract_part,http://www.prisonersofthecensus.org/data/2010blocks/050434903005050/
5.05E+13,100,0,2,0,0,2,0,104,401,505,20.59405941,79.40594059,tract_part,http://www.prisonersofthecensus.org/data/2010blocks/050450304032009/
5.05E+13,41,0,1,0,0,0,5,47,60,107,43.92523364,56.07476636,tract,http://www.prisonersofthecensus.org/data/2010blocks/050450307022044/
5.05E+13,33,0,0,0,0,0,5,38,85,123,30.89430894,69.10569106,tract,http://www.prisonersofthecensus.org/data/2010blocks/050450309003016/
5.05E+13,0,0,0,0,0,0,0,0,7,7,0,100,tract_part,http://www.prisonersofthecensus.org/data/2010blocks/050495502005054/
5.05E+13,72,0,0,0,2,0,6,80,142,222,36.03603604,63.96396396,tract_part,http://www.prisonersofthecensus.org/data/2010blocks/050510108003009/
5.05E+13,0,0,0,0,0,0,0,0,29,29,0,100,tract_part,http://www.prisonersofthecensus.org/data/2010blocks/050510119004095/
5.05E+13,22,0,0,0,6,0,16,44,26,70,62.85714286,37.14285714,tract_part,http://www.prisonersofthecensus.org/data/2010blocks/050534704001016/
5.06E+13,5,0,0,0,0,0,4,9,123,132,6.818181818,93.18181818,tract_part,http://www.prisonersofthecensus.org/data/2010blocks/050554804001000/
5.06E+13,27,0,0,0,1,0,2,30,22,52,57.69230769,42.30769231,tract_part,http://www.prisonersofthecensus.org/data/2010blocks/050574805003003/
5.06E+13,388,0,8,0,0,0,34,430,662,1092,39.37728938,60.62271062,tract_part,http://www.prisonersofthecensus.org/data/2010blocks/050590205002044/
5.06E+13,11,0,0,0,0,0,6,17,74,91,18.68131868,81.31868132,tract_part,http://www.prisonersofthecensus.org/data/2010blocks/050634906002025/
5.07E+13,3,0,0,0,0,0,0,3,25,28,10.71428571,89.28571429,tract_part,http://www.prisonersofthecensus.org/data/2010blocks/050659602001211/
5.07E+13,146,0,2,0,7,2,27,184,398,582,31.61512027,68.38487973,tract_part,http://www.prisonersofthecensus.org/data/2010blocks/050659603002104/
5.07E+13,12,0,0,0,0,0,0,12,40,52,23.07692308,76.92307692,tract_part,http://www.prisonersofthecensus.org/data/2010blocks/050674802004018/
5.07E+13,596,33,5,1,33,25,70,763,1059,1822,41.87705818,58.12294182,tract_part,http://www.prisonersofthecensus.org/data/2010blocks/050674804001056/
5.07E+13,321,0,1,0,0,5,4,331,198,529,62.57088847,37.42911153,institutionalized,http://www.prisonersofthecensus.org/data/2010blocks/050690001021010/
5.07E+13,305,0,4,0,2,3,25,339,453,792,42.8030303,57.1969697,institutionalized,http://www.prisonersofthecensus.org/data/2010blocks/050690001021011/
5.07E+13,38,0,0,0,4,1,9,52,62,114,45.61403509,54.38596491,tract_part,http://www.prisonersofthecensus.org/data/2010blocks/050690023003026/
5.07E+13,199,0,0,0,0,0,4,203,54,257,78.98832685,21.01167315,tract,http://www.prisonersofthecensus.org/data/2010blocks/050690010003027/
5.07E+13,250,0,0,0,0,0,6,256,322,578,44.29065744,55.70934256,institutionalized,http://www.prisonersofthecensus.org/data/2010blocks/050690021033060/
5.07E+13,411,2,3,0,8,1,22,447,422,869,51.43843498,48.56156502,institutionalized,http://www.prisonersofthecensus.org/data/2010blocks/050690021033062/
5.07E+13,60,5,0,0,1,15,10,91,242,333,27.32732733,72.67267267,institutionalized,http://www.prisonersofthecensus.org/data/2010blocks/050690021033065/
5.07E+13,4,0,1,0,1,0,5,11,47,58,18.96551724,81.03448276,tract_part,http://www.prisonersofthecensus.org/data/2010blocks/050719521003002/
5.07E+13,15,0,0,0,0,0,0,15,14,29,51.72413793,48.27586207,tract_part,http://www.prisonersofthecensus.org/data/2010blocks/050734701001202/
5.08E+13,0,0,0,0,0,0,0,0,32,32,0,100,tract_part,http://www.prisonersofthecensus.org/data/2010blocks/050754705023056/
5.08E+13,6,0,0,0,0,0,0,6,1,7,85.71428571,14.28571429,tract_part,http://www.prisonersofthecensus.org/data/2010blocks/050774703005011/
5.08E+13,850,8,6,0,17,8,40,929,772,1701,54.61493239,45.38506761,tract_part,http://www.prisonersofthecensus.org/data/2010blocks/050774701001050/
5.08E+13,1830,4,16,1,64,7,110,2032,1331,3363,60.42224205,39.57775795,tract_part,http://www.prisonersofthecensus.org/data/2010blocks/050799606002047/
5.08E+13,13,1,0,0,0,1,0,15,3,18,83.33333333,16.66666667,tract_part,http://www.prisonersofthecensus.org/data/2010blocks/050799605002026/
5.08E+13,1,0,0,0,0,0,0,1,3,4,25,75,tract_part,http://www.prisonersofthecensus.org/data/2010blocks/050839505001037/
5.08E+13,1,0,0,0,0,0,0,1,22,23,4.347826087,95.65217391,tract_part,http://www.prisonersofthecensus.org/data/2010blocks/050839503002057/
5.09E+13,12,0,0,0,0,0,4,16,45,61,26.2295082,73.7704918,tract_part,http://www.prisonersofthecensus.org/data/2010blocks/050850205001112/
5.09E+13,0,0,0,0,0,0,0,0,3,3,0,100,tract_part,http://www.prisonersofthecensus.org/data/2010blocks/050850202042000/
5.09E+13,1,0,0,0,0,0,0,1,15,16,6.25,93.75,tract_part,http://www.prisonersofthecensus.org/data/2010blocks/050899602012033/
5.09E+13,195,2,1,0,6,0,10,214,391,605,35.37190083,64.62809917,institutionalized,http://www.prisonersofthecensus.org/data/2010blocks/050910204001044/
5.09E+13,29,0,0,0,0,0,6,35,17,52,67.30769231,32.69230769,institutionalized,http://www.prisonersofthecensus.org/data/2010blocks/050910204001075/
5.09E+13,126,0,0,0,3,2,17,148,95,243,60.90534979,39.09465021,tract,http://www.prisonersofthecensus.org/data/2010blocks/050910205002108/
5.09E+13,36,1,1,0,0,1,2,41,43,84,48.80952381,51.19047619,institutionalized,http://www.prisonersofthecensus.org/data/2010blocks/050930109003011/
5.09E+13,103,0,1,0,0,0,4,108,45,153,70.58823529,29.41176471,institutionalized,http://www.prisonersofthecensus.org/data/2010blocks/050930109003085/
5.09E+13,53,2,0,0,1,1,7,64,179,243,26.33744856,73.66255144,tract_part,http://www.prisonersofthecensus.org/data/2010blocks/050930111002037/
5.10E+13,1,0,0,0,0,0,1,2,1,3,66.66666667,33.33333333,tract_part,http://www.prisonersofthecensus.org/data/2010blocks/050959501004000/
5.10E+13,14,0,0,0,0,0,1,15,5,20,75,25,tract_part,http://www.prisonersofthecensus.org/data/2010blocks/050959502001156/
5.10E+13,0,0,0,0,0,0,2,2,6,8,25,75,tract_part,http://www.prisonersofthecensus.org/data/2010blocks/050979530003028/
5.10E+13,5,0,0,0,0,0,0,5,8,13,38.46153846,61.53846154,tract_part,http://www.prisonersofthecensus.org/data/2010blocks/050990902001034/
5.10E+13,39,0,0,0,0,0,1,40,10,50,80,20,tract_part,http://www.prisonersofthecensus.org/data/2010blocks/051039506003014/
5.11E+13,47,0,0,0,0,0,0,47,18,65,72.30769231,27.69230769,tract_part,http://www.prisonersofthecensus.org/data/2010blocks/051074804003010/
5.11E+13,27,0,0,0,0,1,1,29,27,56,51.78571429,48.21428571,tract_part,http://www.prisonersofthecensus.org/data/2010blocks/051099535003117/
5.11E+13,22,0,0,0,1,0,1,24,64,88,27.27272727,72.72727273,tract_part,http://www.prisonersofthecensus.org/data/2010blocks/051114905004012/
5.11E+13,0,1,0,0,0,0,0,1,20,21,4.761904762,95.23809524,tract_part,http://www.prisonersofthecensus.org/data/2010blocks/051139502005011/
5.12E+13,15,1,2,0,5,1,17,41,136,177,23.16384181,76.83615819,tract_part,http://www.prisonersofthecensus.org/data/2010blocks/051159513003022/
5.12E+13,5,0,0,0,0,0,3,8,8,16,50,50,tract_part,http://www.prisonersofthecensus.org/data/2010blocks/051174601003026/
5.12E+13,698,0,2,1,5,1,34,741,292,1033,71.73281704,28.26718296,tract,http://www.prisonersofthecensus.org/data/2010blocks/051190012001065/
5.12E+13,44,0,0,0,1,0,2,47,36,83,56.62650602,43.37349398,tract,http://www.prisonersofthecensus.org/data/2010blocks/051190021021000/
5.12E+13,15,1,0,0,0,0,0,16,20,36,44.44444444,55.55555556,tract,http://www.prisonersofthecensus.org/data/2010blocks/051190024061044/
5.12E+13,518,6,6,2,24,13,66,635,509,1144,55.50699301,44.49300699,tract_part,http://www.prisonersofthecensus.org/data/2010blocks/051190040052021/
5.12E+13,0,0,0,0,0,0,0,0,2,2,0,100,tract_part,http://www.prisonersofthecensus.org/data/2010blocks/051190035003044/
5.12E+13,1,0,0,0,0,1,0,2,30,32,6.25,93.75,tract_part,http://www.prisonersofthecensus.org/data/2010blocks/051219603021015/
5.12E+13,1706,77,33,5,270,108,771,2970,1242,4212,70.51282051,29.48717949,institutionalized,http://www.prisonersofthecensus.org/data/2010blocks/051239606001000/
5.12E+13,64,0,0,0,1,1,2,68,24,92,73.91304348,26.08695652,institutionalized,http://www.prisonersofthecensus.org/data/2010blocks/051239606005019/
5.13E+13,27,0,0,0,0,0,4,31,142,173,17.91907514,82.08092486,tract_part,http://www.prisonersofthecensus.org/data/2010blocks/051250106004000/
5.13E+13,110,0,0,0,0,0,4,114,134,248,45.96774194,54.03225806,tract_part,http://www.prisonersofthecensus.org/data/2010blocks/051250105033053/
5.13E+13,0,0,0,0,0,0,2,2,9,11,18.18181818,81.81818182,tract_part,http://www.prisonersofthecensus.org/data/2010blocks/051299702002075/
5.13E+13,68,6,11,0,20,0,58,163,274,437,37.29977117,62.70022883,tract,http://www.prisonersofthecensus.org/data/2010blocks/051310003002088/
5.13E+13,0,0,0,0,3,0,3,6,1,7,85.71428571,14.28571429,institutionalized,http://www.prisonersofthecensus.org/data/2010blocks/051330803002046/
5.13E+13,2,0,0,0,3,1,8,14,15,29,48.27586207,51.72413793,institutionalized,http://www.prisonersofthecensus.org/data/2010blocks/051330803003000/
5.14E+13,3,0,0,0,0,1,0,4,21,25,16,84,tract_part,http://www.prisonersofthecensus.org/data/2010blocks/051354703001068/
5.14E+13,0,0,0,0,0,0,0,0,24,24,0,100,tract_part,http://www.prisonersofthecensus.org/data/2010blocks/051379502023034/
5.14E+13,117,0,0,0,0,1,3,121,65,186,65.05376344,34.94623656,tract_part,http://www.prisonersofthecensus.org/data/2010blocks/051399510002010/
5.14E+13,0,0,1,0,0,0,8,9,41,50,18,82,tract_part,http://www.prisonersofthecensus.org/data/2010blocks/051414603023058/
5.14E+13,72,1,2,0,11,1,103,190,332,522,36.39846743,63.60153257,tract_part,http://www.prisonersofthecensus.org/data/2010blocks/051430111012054/
5.14E+13,3,2,0,0,2,0,2,9,92,101,8.910891089,91.08910891,tract,http://www.prisonersofthecensus.org/data/2010blocks/051430113006022/
5.14E+13,4,0,1,0,1,0,5,11,44,55,20,80,tract,http://www.prisonersofthecensus.org/data/2010blocks/051430112001028/
5.15E+13,4,0,0,0,0,0,0,4,4,8,50,50,tract_part,http://www.prisonersofthecensus.org/data/2010blocks/051474902002035/
5.15E+13,1,0,2,0,0,0,0,3,10,13,23.07692308,76.92307692,tract_part,http://www.prisonersofthecensus.org/data/2010blocks/051499525002033/
6.00E+13,0,0,2,0,0,1,4,7,8,15,46.66666667,53.33333333,tract,http://www.prisonersofthecensus.org/data/2010blocks/060014227002006/
6.00E+13,45,0,22,2,0,0,16,85,22,107,79.43925234,20.56074766,tract,http://www.prisonersofthecensus.org/data/2010blocks/060014231001000/
6.00E+13,143,90,62,30,191,118,732,1366,276,1642,83.19123021,16.80876979,institutionalized,http://www.prisonersofthecensus.org/data/2010blocks/060014501021012/
6.00E+13,2449,9,106,105,474,8,972,4123,718,4841,85.16835365,14.83164635,institutionalized,http://www.prisonersofthecensus.org/data/2010blocks/060014501022000/
6.00E+13,3,0,0,0,0,0,0,3,0,3,100,0,tract,http://www.prisonersofthecensus.org/data/2010blocks/060014010005005/
6.00E+13,452,1,21,3,118,1,238,834,88,922,90.45553145,9.544468547,tract,http://www.prisonersofthecensus.org/data/2010blocks/060014031001028/
6.00E+13,27,0,1,1,0,1,16,46,27,73,63.01369863,36.98630137,tract,http://www.prisonersofthecensus.org/data/2010blocks/060014036002000/
6.00E+13,38,1,0,0,1,0,4,44,4,48,91.66666667,8.333333333,tract,http://www.prisonersofthecensus.org/data/2010blocks/060014062014000/
6.01E+13,700,73,51,14,461,42,1280,2621,1628,4249,61.68510238,38.31489762,tract_part,http://www.prisonersofthecensus.org/data/2010blocks/060050003012025/
6.01E+13,4,8,6,1,6,0,11,36,67,103,34.95145631,65.04854369,tract_part,http://www.prisonersofthecensus.org/data/2010blocks/060050004012027/
6.01E+13,19,1,1,1,15,1,37,75,4,79,94.93670886,5.063291139,tract_part,http://www.prisonersofthecensus.org/data/2010blocks/060050004022023/
6.01E+13,46,14,19,0,38,2,118,237,359,596,39.76510067,60.23489933,tract_part,http://www.prisonersofthecensus.org/data/2010blocks/060070025003000/
6.01E+13,28,0,3,0,26,1,24,82,36,118,69.49152542,30.50847458,tract_part,http://www.prisonersofthecensus.org/data/2010blocks/060090001223066/
6.01E+13,1,2,0,0,4,0,5,12,66,78,15.38461538,84.61538462,tract_part,http://www.prisonersofthecensus.org/data/2010blocks/060090003004020/
6.01E+13,1,2,0,0,0,0,30,33,14,47,70.21276596,29.78723404,tract_part,http://www.prisonersofthecensus.org/data/2010blocks/060110002005038/
6.01E+13,32,0,2,0,1,0,20,55,32,87,63.2183908,36.7816092,tract_part,http://www.prisonersofthecensus.org/data/2010blocks/060133141043000/
6.01E+13,0,0,1,1,0,0,0,2,0,2,100,0,tract_part,http://www.prisonersofthecensus.org/data/2010blocks/060133131031024/
6.01E+13,213,1,12,6,70,9,155,466,203,669,69.65620329,30.34379671,tract,http://www.prisonersofthecensus.org/data/2010blocks/060133160001028/
6.01E+13,24,0,6,0,0,1,9,40,28,68,58.82352941,41.17647059,tract_part,http://www.prisonersofthecensus.org/data/2010blocks/060133551121110/
6.01E+13,289,0,20,1,126,9,181,626,214,840,74.52380952,25.47619048,tract_part,http://www.prisonersofthecensus.org/data/2010blocks/060133922002024/
6.02E+13,5,19,0,1,5,1,14,45,61,106,42.45283019,57.54716981,tract_part,http://www.prisonersofthecensus.org/data/2010blocks/060150001011057/
6.02E+13,869,32,15,0,534,27,1835,3312,517,3829,86.4977801,13.5022199,tract_part,http://www.prisonersofthecensus.org/data/2010blocks/060150002013063/
6.02E+13,11,1,1,0,15,4,32,64,55,119,53.78151261,46.21848739,tract_part,http://www.prisonersofthecensus.org/data/2010blocks/060150002031298/
6.02E+13,36,0,1,0,3,0,40,80,34,114,70.1754386,29.8245614,tract_part,http://www.prisonersofthecensus.org/data/2010blocks/060170306022073/
6.02E+13,34,3,1,0,2,3,30,73,152,225,32.44444444,67.55555556,tract_part,http://www.prisonersofthecensus.org/data/2010blocks/060170312003029/
6.02E+13,3,7,1,1,13,5,28,58,69,127,45.66929134,54.33070866,tract_part,http://www.prisonersofthecensus.org/data/2010blocks/060170302002016/
6.02E+13,224,13,7,3,36,3,142,428,558,986,43.40770791,56.59229209,tract_part,http://www.prisonersofthecensus.org/data/2010blocks/060190079011000/
6.02E+13,96,9,30,2,58,12,211,418,135,553,75.58770344,24.41229656,tract_part,http://www.prisonersofthecensus.org/data/2010blocks/060190080001000/
6.02E+13,1291,62,33,6,625,44,1942,4003,1325,5328,75.13138138,24.86861862,tract_part,http://www.prisonersofthecensus.org/data/2010blocks/060190079011001/
6.02E+13,406,18,111,0,3,3,1374,1915,435,2350,81.4893617,18.5106383,tract,http://www.prisonersofthecensus.org/data/2010blocks/060190001001020/
6.02E+13,6,2,3,0,1,3,8,23,12,35,65.71428571,34.28571429,tract_part,http://www.prisonersofthecensus.org/data/2010blocks/060190007002030/
6.02E+13,7,5,0,0,2,3,17,34,20,54,62.96296296,37.03703704,institutionalized,http://www.prisonersofthecensus.org/data/2010blocks/060190020001012/
6.02E+13,0,0,6,0,0,0,0,6,0,6,100,0,institutionalized,http://www.prisonersofthecensus.org/data/2010blocks/060190020002037/
6.02E+13,19,0,2,1,7,0,27,56,27,83,67.46987952,32.53012048,tract_part,http://www.prisonersofthecensus.org/data/2010blocks/060190064031068/
6.02E+13,3,1,1,0,15,2,34,56,44,100,56,44,tract_part,http://www.prisonersofthecensus.org/data/2010blocks/060210104005052/
6.02E+13,10,73,3,4,10,1,14,115,287,402,28.60696517,71.39303483,tract_part,http://www.prisonersofthecensus.org/data/2010blocks/060230005001087/
6.02E+13,25,2,4,1,14,2,34,82,32,114,71.92982456,28.07017544,tract_part,http://www.prisonersofthecensus.org/data/2010blocks/060230111003119/
6.02E+13,22,4,3,0,12,1,29,71,49,120,59.16666667,40.83333333,tract_part,http://www.prisonersofthecensus.org/data/2010blocks/060230115003028/
6.03E+13,1510,37,60,11,578,41,1913,4150,638,4788,86.67502089,13.32497911,tract_part,http://www.prisonersofthecensus.org/data/2010blocks/060250101011178/
6.03E+13,52,13,23,1,166,5,206,466,110,576,80.90277778,19.09722222,tract,http://www.prisonersofthecensus.org/data/2010blocks/060250115004006/
6.03E+13,16,5,0,0,15,3,563,602,52,654,92.04892966,7.951070336,tract_part,http://www.prisonersofthecensus.org/data/2010blocks/060250113001256/
6.03E+13,1464,20,43,1,11,4,2275,3818,496,4314,88.50254984,11.49745016,institutionalized,http://www.prisonersofthecensus.org/data/2010blocks/060250123011297/
6.03E+13,74,0,1,0,0,0,110,185,8,193,95.85492228,4.14507772,institutionalized,http://www.prisonersofthecensus.org/data/2010blocks/060250123011394/
6.03E+13,37,0,2,0,19,1,26,85,46,131,64.88549618,35.11450382,tract_part,http://www.prisonersofthecensus.org/data/2010blocks/060270002001240/
6.03E+13,0,18,0,0,4,0,10,32,30,62,51.61290323,48.38709677,tract_part,http://www.prisonersofthecensus.org/data/2010blocks/060270005001797/
6.03E+13,2,2,4,1,8,2,10,29,9,38,76.31578947,23.68421053,tract,http://www.prisonersofthecensus.org/data/2010blocks/060290019023019/
6.03E+13,1,0,0,0,1,0,2,4,3,7,57.14285714,42.85714286,tract,http://www.prisonersofthecensus.org/data/2010blocks/060290031152013/
6.03E+13,11,6,4,2,10,5,25,63,31,94,67.0212766,32.9787234,tract_part,http://www.prisonersofthecensus.org/data/2010blocks/060290012012002/
6.03E+13,1903,30,0,2,686,43,1996,4660,1433,6093,76.48120794,23.51879206,tract,http://www.prisonersofthecensus.org/data/2010blocks/060290046011000/
6.03E+13,105,2,1,0,78,10,285,481,104,585,82.22222222,17.77777778,tract,http://www.prisonersofthecensus.org/data/2010blocks/060290046031000/
6.03E+13,1647,33,7,0,856,42,2280,4865,709,5574,87.28022964,12.71977036,tract_part,http://www.prisonersofthecensus.org/data/2010blocks/060290046042015/
6.03E+13,141,3,4,2,376,10,734,1270,287,1557,81.56711625,18.43288375,tract_part,http://www.prisonersofthecensus.org/data/2010blocks/060290047013003/
6.03E+13,21,0,55,1,0,10,2513,2600,34,2634,98.70918755,1.290812453,tract_part,http://www.prisonersofthecensus.org/data/2010blocks/060290065002695/
6.03E+13,69,11,30,2,159,24,273,568,131,699,81.25894134,18.74105866,tract_part,http://www.prisonersofthecensus.org/data/2010blocks/060290040001061/
6.03E+13,281,13,14,0,227,23,705,1263,463,1726,73.17497103,26.82502897,institutionalized,http://www.prisonersofthecensus.org/data/2010blocks/060290039001082/
6.03E+13,4,1,0,0,11,0,17,33,20,53,62.26415094,37.73584906,institutionalized,http://www.prisonersofthecensus.org/data/2010blocks/060290039002000/
6.03E+13,1154,82,50,14,1532,108,2785,5725,1882,7607,75.25962929,24.74037071,tract,http://www.prisonersofthecensus.org/data/2010blocks/060290060021000/
6.03E+13,1339,51,41,1,123,44,2625,4224,1624,5848,72.22982216,27.77017784,tract,http://www.prisonersofthecensus.org/data/2010blocks/060290043021001/
6.03E+13,84,1,3,1,36,2,258,385,132,517,74.46808511,25.53191489,institutionalized,http://www.prisonersofthecensus.org/data/2010blocks/060290033043554/
6.03E+13,252,5,15,0,14,25,1444,1755,631,2386,73.55406538,26.44593462,institutionalized,http://www.prisonersofthecensus.org/data/2010blocks/060290033043645/
6.03E+13,1506,74,52,3,2943,12,2844,7434,1770,9204,80.76923077,19.23076923,tract,http://www.prisonersofthecensus.org/data/2010blocks/060319818001000/
6.03E+13,45,11,8,2,91,7,161,325,80,405,80.24691358,19.75308642,tract_part,http://www.prisonersofthecensus.org/data/2010blocks/060310010012042/
6.03E+13,3,0,1,0,5,0,7,16,9,25,64,36,tract_part,http://www.prisonersofthecensus.org/data/2010blocks/060310003002014/
6.03E+13,1503,46,7,3,2506,14,2428,6507,1201,7708,84.41878568,15.58121432,institutionalized,http://www.prisonersofthecensus.org/data/2010blocks/060310016021001/
6.03E+13,1716,63,37,5,3132,13,3023,7989,1775,9764,81.82097501,18.17902499,institutionalized,http://www.prisonersofthecensus.org/data/2010blocks/060310016021006/
6.03E+13,27,1,2,0,13,4,31,78,41,119,65.54621849,34.45378151,tract_part,http://www.prisonersofthecensus.org/data/2010blocks/060330009001060/
6.03E+13,21,13,4,0,6,10,34,88,133,221,39.81900452,60.18099548,tract_part,http://www.prisonersofthecensus.org/data/2010blocks/060330003001003/
6.03E+13,0,6,0,0,1,0,1,8,26,34,23.52941176,76.47058824,tract_part,http://www.prisonersofthecensus.org/data/2010blocks/060330013005125/
6.04E+13,17,0,1,0,10,2,28,58,35,93,62.3655914,37.6344086,tract_part,http://www.prisonersofthecensus.org/data/2010blocks/060350401001041/
6.04E+13,414,60,43,18,148,46,303,1032,273,1305,79.08045977,20.91954023,tract_part,http://www.prisonersofthecensus.org/data/2010blocks/060350406001212/
6.04E+13,30,9,9,1,25,8,32,114,104,218,52.29357798,47.70642202,tract_part,http://www.prisonersofthecensus.org/data/2010blocks/060350403031073/
6.04E+13,1095,88,28,3,1344,34,1546,4138,1179,5317,77.82584164,22.17415836,institutionalized,http://www.prisonersofthecensus.org/data/2010blocks/060350404002001/
6.04E+13,66,4,5,0,49,0,79,203,125,328,61.8902439,38.1097561,institutionalized,http://www.prisonersofthecensus.org/data/2010blocks/060350404002003/
6.04E+13,224,26,8,0,146,4,330,738,258,996,74.09638554,25.90361446,institutionalized,http://www.prisonersofthecensus.org/data/2010blocks/060350404002007/
6.04E+13,113,6,0,0,183,1,172,475,192,667,71.2143928,28.7856072,institutionalized,http://www.prisonersofthecensus.org/data/2010blocks/060350404002010/
6.04E+13,586,53,10,1,758,23,843,2274,800,3074,73.97527651,26.02472349,institutionalized,http://www.prisonersofthecensus.org/data/2010blocks/060350404002015/
6.04E+13,0,1,0,0,0,0,1,2,4,6,33.33333333,66.66666667,tract_part,http://www.prisonersofthecensus.org/data/2010blocks/060378005062003/
6.04E+13,9,4,4,0,2,4,19,42,55,97,43.29896907,56.70103093,tract_part,http://www.prisonersofthecensus.org/data/2010blocks/060378004061063/
6.04E+13,0,0,0,0,5,0,13,18,0,18,100,0,tract_part,http://www.prisonersofthecensus.org/data/2010blocks/060375439053021/
6.04E+13,726,7,15,3,374,34,715,1874,372,2246,83.43722173,16.56277827,tract,http://www.prisonersofthecensus.org/data/2010blocks/060375405012005/
6.04E+13,11,0,18,1,2,0,14,46,42,88,52.27272727,47.72727273,tract,http://www.prisonersofthecensus.org/data/2010blocks/060375548021008/
6.04E+13,0,0,0,0,0,0,6,6,1,7,85.71428571,14.28571429,tract,http://www.prisonersofthecensus.org/data/2010blocks/060375542031004/
6.04E+13,7,0,2,0,0,0,5,14,2,16,87.5,12.5,tract,http://www.prisonersofthecensus.org/data/2010blocks/060375523011004/
6.04E+13,36,1,0,0,0,5,48,90,37,127,70.86614173,29.13385827,tract,http://www.prisonersofthecensus.org/data/2010blocks/060374021011014/
6.04E+13,6,0,1,0,0,1,8,16,0,16,100,0,tract,http://www.prisonersofthecensus.org/data/2010blocks/060374088002057/
6.04E+13,0,0,0,0,1,0,4,5,0,5,100,0,tract,http://www.prisonersofthecensus.org/data/2010blocks/060376024023002/
6.04E+13,22,1,0,0,3,1,10,37,10,47,78.72340426,21.27659574,tract,http://www.prisonersofthecensus.org/data/2010blocks/060376011001013/
6.04E+13,40,2,0,0,4,1,19,66,6,72,91.66666667,8.333333333,tract_part,http://www.prisonersofthecensus.org/data/2010blocks/060376018011000/
6.04E+13,4,0,0,0,0,2,0,6,0,6,100,0,tract,http://www.prisonersofthecensus.org/data/2010blocks/060376041002003/
6.04E+13,0,0,3,0,0,0,0,3,0,3,100,0,tract,http://www.prisonersofthecensus.org/data/2010blocks/060375727004007/
6.04E+13,17,2,4,0,4,0,7,34,20,54,62.96296296,37.03703704,tract,http://www.prisonersofthecensus.org/data/2010blocks/060375728001015/
6.04E+13,0,0,1,0,0,0,0,1,3,4,25,75,tract,http://www.prisonersofthecensus.org/data/2010blocks/060375743004003/
6.04E+13,39,3,3,0,10,0,18,73,28,101,72.27722772,27.72277228,tract_part,http://www.prisonersofthecensus.org/data/2010blocks/060375760012010/
6.04E+13,6,0,0,1,3,0,3,13,3,16,81.25,18.75,tract,http://www.prisonersofthecensus.org/data/2010blocks/060375769012002/
6.04E+13,13,2,2,0,13,1,28,59,16,75,78.66666667,21.33333333,tract,http://www.prisonersofthecensus.org/data/2010blocks/060371902012000/
6.04E+13,29,0,3,0,6,1,18,57,13,70,81.42857143,18.57142857,tract,http://www.prisonersofthecensus.org/data/2010blocks/060371905101004/
6.04E+13,23,1,1,0,6,6,19,56,14,70,80,20,tract,http://www.prisonersofthecensus.org/data/2010blocks/060371974201000/
6.04E+13,0,0,0,0,0,0,3,3,1,4,75,25,tract,http://www.prisonersofthecensus.org/data/2010blocks/060372035001010/
6.04E+13,1358,22,97,16,675,50,2092,4310,674,4984,86.47672552,13.52327448,institutionalized,http://www.prisonersofthecensus.org/data/2010blocks/060372060201004/
6.04E+13,1595,9,54,4,424,48,830,2964,794,3758,78.87174029,21.12825971,institutionalized,http://www.prisonersofthecensus.org/data/2010blocks/060372060201006/
6.04E+13,1,0,0,0,0,0,1,2,3,5,40,60,tract,http://www.prisonersofthecensus.org/data/2010blocks/060372062002011/
6.04E+13,58,0,2,0,16,0,48,124,14,138,89.85507246,10.14492754,institutionalized,http://www.prisonersofthecensus.org/data/2010blocks/060372074001037/
6.04E+13,222,20,64,1,304,37,596,1244,255,1499,82.98865911,17.01134089,institutionalized,http://www.prisonersofthecensus.org/data/2010blocks/060372074001038/
6.04E+13,3,0,0,0,0,1,0,4,4,8,50,50,tract,http://www.prisonersofthecensus.org/data/2010blocks/060372127011002/
6.04E+13,61,3,2,1,26,10,45,148,23,171,86.5497076,13.4502924,tract,http://www.prisonersofthecensus.org/data/2010blocks/060372311001009/
6.04E+13,15,0,0,0,0,2,2,19,2,21,90.47619048,9.523809524,tract,http://www.prisonersofthecensus.org/data/2010blocks/060372375002005/
6.04E+13,2,0,0,0,2,0,2,6,0,6,100,0,tract,http://www.prisonersofthecensus.org/data/2010blocks/060372962203015/
6.04E+13,0,0,0,0,0,0,0,0,1,1,0,100,tract,http://www.prisonersofthecensus.org/data/2010blocks/060372971101014/
6.04E+13,206,27,43,20,134,50,368,848,309,1157,73.29299914,26.70700086,tract_part,http://www.prisonersofthecensus.org/data/2010blocks/060379800311064/
6.04E+13,25,0,0,0,25,0,25,75,24,99,75.75757576,24.24242424,tract_part,http://www.prisonersofthecensus.org/data/2010blocks/060379200111019/
6.04E+13,405,1,7,1,641,9,703,1767,223,1990,88.79396985,11.20603015,institutionalized,http://www.prisonersofthecensus.org/data/2010blocks/060379202001025/
6.04E+13,522,6,11,3,917,8,1036,2503,135,2638,94.88248673,5.117513268,institutionalized,http://www.prisonersofthecensus.org/data/2010blocks/060379202001031/
6.04E+13,1162,7,12,2,2178,24,2371,5756,326,6082,94.63992108,5.360078921,institutionalized,http://www.prisonersofthecensus.org/data/2010blocks/060379202001039/
6.04E+13,4,0,0,0,0,0,0,4,0,4,100,0,tract,http://www.prisonersofthecensus.org/data/2010blocks/060379005012007/
6.04E+13,0,0,0,0,0,0,0,0,2,2,0,100,tract,http://www.prisonersofthecensus.org/data/2010blocks/060379005071007/
6.04E+13,0,0,0,0,7,7,14,28,0,28,100,0,tract,http://www.prisonersofthecensus.org/data/2010blocks/060379007011012/
6.04E+13,0,0,1,0,5,0,5,11,2,13,84.61538462,15.38461538,tract,http://www.prisonersofthecensus.org/data/2010blocks/060379008061015/
6.04E+13,1677,36,35,0,1703,154,1748,5353,825,6178,86.64616381,13.35383619,remaining,http://www.prisonersofthecensus.org/data/2010blocks/060379010031001/
6.04E+13,71,6,86,3,589,23,910,1688,30,1718,98.25378347,1.746216531,institutionalized,http://www.prisonersofthecensus.org/data/2010blocks/060379010031003/
6.04E+13,0,0,0,0,0,1,1,2,1,3,66.66666667,33.33333333,tract,http://www.prisonersofthecensus.org/data/2010blocks/060379010093014/
6.04E+13,4,0,0,0,0,0,0,4,0,4,100,0,tract_part,http://www.prisonersofthecensus.org/data/2010blocks/060379012131081/
6.04E+13,0,0,0,0,1,0,1,2,0,2,100,0,tract_part,http://www.prisonersofthecensus.org/data/2010blocks/060375990002013/
6.04E+13,12,0,0,0,1,1,10,24,19,43,55.81395349,44.18604651,tract,http://www.prisonersofthecensus.org/data/2010blocks/060371061141000/
6.04E+13,14,0,3,0,0,0,13,30,74,104,28.84615385,71.15384615,tract,http://www.prisonersofthecensus.org/data/2010blocks/060371064071000/
6.04E+13,0,0,9,0,0,0,0,9,0,9,100,0,tract,http://www.prisonersofthecensus.org/data/2010blocks/060371111001002/
6.04E+13,3,0,0,0,0,0,0,3,0,3,100,0,tract,http://www.prisonersofthecensus.org/data/2010blocks/060371134011005/
6.04E+13,9,0,3,0,5,1,15,33,65,98,33.67346939,66.32653061,tract,http://www.prisonersofthecensus.org/data/2010blocks/060371204001006/
6.04E+13,0,0,0,0,0,0,2,2,4,6,33.33333333,66.66666667,tract,http://www.prisonersofthecensus.org/data/2010blocks/060371211021027/
6.04E+13,9,0,0,0,4,1,13,27,30,57,47.36842105,52.63157895,tract,http://www.prisonersofthecensus.org/data/2010blocks/060371275202004/
6.04E+13,0,0,0,0,10,0,10,20,0,20,100,0,tract,http://www.prisonersofthecensus.org/data/2010blocks/060371278053004/
6.04E+13,4,0,0,0,0,0,0,4,0,4,100,0,tract,http://www.prisonersofthecensus.org/data/2010blocks/060371341011007/
6.04E+13,0,0,4,0,0,0,0,4,0,4,100,0,tract,http://www.prisonersofthecensus.org/data/2010blocks/060371352012000/
6.04E+13,0,0,2,0,0,0,0,2,0,2,100,0,tract,http://www.prisonersofthecensus.org/data/2010blocks/060377022014013/
6.04E+13,0,0,0,0,0,0,1,1,0,1,100,0,tract_part,http://www.prisonersofthecensus.org/data/2010blocks/060379104012011/
6.04E+13,4,0,0,0,0,0,0,4,0,4,100,0,tract,http://www.prisonersofthecensus.org/data/2010blocks/060379106031021/
6.04E+13,37,0,2,0,30,0,44,113,22,135,83.7037037,16.2962963,tract_part,http://www.prisonersofthecensus.org/data/2010blocks/060379108051138/
6.04E+13,24,0,0,1,8,1,33,67,26,93,72.04301075,27.95698925,tract,http://www.prisonersofthecensus.org/data/2010blocks/060379108111025/
6.04E+13,35,1,0,1,3,2,47,89,32,121,73.55371901,26.44628099,institutionalized,http://www.prisonersofthecensus.org/data/2010blocks/060379303011081/
6.04E+13,36,0,6,1,12,2,19,76,37,113,67.25663717,32.74336283,institutionalized,http://www.prisonersofthecensus.org/data/2010blocks/060379303012071/
6.04E+13,4,3,0,0,0,0,3,10,2,12,83.33333333,16.66666667,tract,http://www.prisonersofthecensus.org/data/2010blocks/060375307001022/
6.04E+13,2,0,0,0,2,0,3,7,2,9,77.77777778,22.22222222,tract,http://www.prisonersofthecensus.org/data/2010blocks/060375331062002/
6.04E+13,2,0,2,0,2,1,19,26,5,31,83.87096774,16.12903226,tract,http://www.prisonersofthecensus.org/data/2010blocks/060374810011003/
6.04E+13,0,0,0,0,0,0,0,0,2,2,0,100,tract,http://www.prisonersofthecensus.org/data/2010blocks/060375300061009/
6.04E+13,0,0,0,0,0,0,3,3,0,3,100,0,tract,http://www.prisonersofthecensus.org/data/2010blocks/060374822011006/
6.04E+13,13,2,3,0,3,0,29,50,12,62,80.64516129,19.35483871,tract,http://www.prisonersofthecensus.org/data/2010blocks/060374333041001/
6.04E+13,4,1,0,0,4,0,5,14,6,20,70,30,tract,http://www.prisonersofthecensus.org/data/2010blocks/060374303025001/
6.04E+13,21,0,2,0,5,1,19,48,3,51,94.11764706,5.882352941,tract,http://www.prisonersofthecensus.org/data/2010blocks/060375028022021/
6.04E+13,943,118,16,5,653,26,1094,2855,1163,4018,71.05525137,28.94474863,institutionalized,http://www.prisonersofthecensus.org/data/2010blocks/060390002011054/
6.04E+13,1148,74,35,15,514,33,1277,3096,1031,4127,75.01817301,24.98182699,institutionalized,http://www.prisonersofthecensus.org/data/2010blocks/060390002011055/
6.04E+13,38,8,5,0,47,6,234,338,133,471,71.76220807,28.23779193,tract_part,http://www.prisonersofthecensus.org/data/2010blocks/060390005081058/
6.04E+13,7,0,0,0,0,0,0,7,1,8,87.5,12.5,tract_part,http://www.prisonersofthecensus.org/data/2010blocks/060390006042001/
6.04E+13,0,0,0,0,0,0,0,0,2,2,0,100,tract,http://www.prisonersofthecensus.org/data/2010blocks/060411022032034/
6.04E+13,1974,120,54,12,705,64,958,3887,1572,5459,71.20351713,28.79648287,tract,http://www.prisonersofthecensus.org/data/2010blocks/060411220001000/
6.04E+13,44,5,6,2,30,13,67,167,126,293,56.99658703,43.00341297,tract_part,http://www.prisonersofthecensus.org/data/2010blocks/060411060022015/
6.04E+13,0,10,0,0,0,0,3,13,24,37,35.13513514,64.86486486,tract_part,http://www.prisonersofthecensus.org/data/2010blocks/060430001013004/
6.04E+13,25,1,3,2,29,1,29,90,33,123,73.17073171,26.82926829,tract_part,http://www.prisonersofthecensus.org/data/2010blocks/060430001014037/
6.05E+13,7,0,0,0,2,0,4,13,8,21,61.9047619,38.0952381,institutionalized,http://www.prisonersofthecensus.org/data/2010blocks/060450103002217/
6.05E+13,19,1,2,0,14,5,30,71,27,98,72.44897959,27.55102041,institutionalized,http://www.prisonersofthecensus.org/data/2010blocks/060450103002219/
6.05E+13,29,3,2,1,21,2,32,90,42,132,68.18181818,31.81818182,institutionalized,http://www.prisonersofthecensus.org/data/2010blocks/060450103002240/
6.05E+13,12,21,6,0,17,9,57,122,245,367,33.24250681,66.75749319,tract_part,http://www.prisonersofthecensus.org/data/2010blocks/060450114002004/
6.05E+13,0,0,0,0,4,0,5,9,0,9,100,0,tract_part,http://www.prisonersofthecensus.org/data/2010blocks/060450113002063/
6.05E+13,496,62,47,24,194,44,416,1283,235,1518,84.51910408,15.48089592,tract_part,http://www.prisonersofthecensus.org/data/2010blocks/060470005031099/
6.05E+13,1,1,0,0,27,3,80,112,25,137,81.75182482,18.24817518,tract,http://www.prisonersofthecensus.org/data/2010blocks/060470013012038/
6.05E+13,54,3,8,1,59,10,237,372,236,608,61.18421053,38.81578947,tract_part,http://www.prisonersofthecensus.org/data/2010blocks/060470009013080/
6.05E+13,1,1,0,0,0,0,0,2,11,13,15.38461538,84.61538462,tract_part,http://www.prisonersofthecensus.org/data/2010blocks/060490001003015/
6.05E+13,33,3,3,0,9,0,25,73,52,125,58.4,41.6,tract_part,http://www.prisonersofthecensus.org/data/2010blocks/060490003001666/
6.05E+13,1,1,0,0,6,0,7,15,7,22,68.18181818,31.81818182,tract_part,http://www.prisonersofthecensus.org/data/2010blocks/060510001023191/
6.05E+13,1915,75,231,63,524,19,2627,5454,1295,6749,80.81197214,19.18802786,institutionalized,http://www.prisonersofthecensus.org/data/2010blocks/060530109001006/
6.05E+13,209,12,40,5,127,3,456,852,252,1104,77.17391304,22.82608696,institutionalized,http://www.prisonersofthecensus.org/data/2010blocks/060530109001008/
6.05E+13,555,45,91,13,352,16,1273,2345,757,3102,75.59638943,24.40361057,institutionalized,http://www.prisonersofthecensus.org/data/2010blocks/060530109001011/
6.05E+13,40,2,1,2,11,1,42,99,34,133,74.43609023,25.56390977,institutionalized,http://www.prisonersofthecensus.org/data/2010blocks/060530109001020/
6.05E+13,8,0,2,0,5,0,27,42,17,59,71.18644068,28.81355932,tract,http://www.prisonersofthecensus.org/data/2010blocks/060530013001022/
6.05E+13,94,3,17,5,114,10,670,913,201,1114,81.95691203,18.04308797,tract,http://www.prisonersofthecensus.org/data/2010blocks/060530106081007/
6.06E+13,21,7,6,1,14,0,50,99,142,241,41.07883817,58.92116183,tract,http://www.prisonersofthecensus.org/data/2010blocks/060552002022003/
6.06E+13,0,0,0,0,0,0,0,0,10,10,0,100,tract_part,http://www.prisonersofthecensus.org/data/2010blocks/060552014032020/
6.06E+13,15,0,4,0,1,1,43,64,119,183,34.9726776,65.0273224,tract_part,http://www.prisonersofthecensus.org/data/2010blocks/060570008021009/
6.06E+13,19,0,2,0,12,1,32,66,44,110,60,40,tract_part,http://www.prisonersofthecensus.org/data/2010blocks/060570008012065/
6.06E+13,0,4,0,0,0,0,7,11,9,20,55,45,institutionalized,http://www.prisonersofthecensus.org/data/2010blocks/060590872001010/
6.06E+13,0,0,1,0,0,0,29,30,16,46,65.2173913,34.7826087,institutionalized,http://www.prisonersofthecensus.org/data/2010blocks/060590872002026/
6.06E+13,7,1,9,1,8,0,18,44,25,69,63.76811594,36.23188406,tract,http://www.prisonersofthecensus.org/data/2010blocks/060590882013002/
6.06E+13,0,0,7,0,0,0,0,7,0,7,100,0,tract,http://www.prisonersofthecensus.org/data/2010blocks/060590887022018/
6.06E+13,0,0,0,0,0,0,1,1,2,3,33.33333333,66.66666667,tract_part,http://www.prisonersofthecensus.org/data/2010blocks/060590219134028/
6.06E+13,0,0,0,0,0,0,1,1,4,5,20,80,tract_part,http://www.prisonersofthecensus.org/data/2010blocks/060590758061000/
6.06E+13,0,0,0,0,0,0,2,2,3,5,40,60,tract,http://www.prisonersofthecensus.org/data/2010blocks/060590758072005/
6.06E+13,197,3,108,19,16,1,1521,1865,764,2629,70.93952073,29.06047927,tract_part,http://www.prisonersofthecensus.org/data/2010blocks/060590761022005/
6.06E+13,36,0,36,0,0,0,315,387,79,466,83.0472103,16.9527897,institutionalized,http://www.prisonersofthecensus.org/data/2010blocks/060590751001002/
6.06E+13,142,2,102,7,26,0,727,1006,732,1738,57.88262371,42.11737629,institutionalized,http://www.prisonersofthecensus.org/data/2010blocks/060590751001008/
6.06E+13,0,0,0,0,0,0,0,0,6,6,0,100,tract,http://www.prisonersofthecensus.org/data/2010blocks/060590754051001/
6.06E+13,18,1,26,1,4,0,307,357,171,528,67.61363636,32.38636364,tract_part,http://www.prisonersofthecensus.org/data/2010blocks/060590524041035/
6.06E+13,1,0,0,0,1,0,5,7,8,15,46.66666667,53.33333333,tract,http://www.prisonersofthecensus.org/data/2010blocks/060590995041002/
6.06E+13,0,0,0,0,0,0,0,0,4,4,0,100,tract_part,http://www.prisonersofthecensus.org/data/2010blocks/060590423241012/
6.06E+13,0,0,0,0,1,0,23,24,0,24,100,0,tract,http://www.prisonersofthecensus.org/data/2010blocks/060590421071013/
6.06E+13,23,1,6,0,32,4,36,102,228,330,30.90909091,69.09090909,institutionalized,http://www.prisonersofthecensus.org/data/2010blocks/060610215012012/
6.06E+13,13,4,8,0,0,0,38,63,188,251,25.09960159,74.90039841,institutionalized,http://www.prisonersofthecensus.org/data/2010blocks/060610215012015/
6.06E+13,0,0,0,0,0,0,1,1,2,3,33.33333333,66.66666667,tract,http://www.prisonersofthecensus.org/data/2010blocks/060610210451001/
6.06E+13,4,4,0,0,0,1,3,12,27,39,30.76923077,69.23076923,tract_part,http://www.prisonersofthecensus.org/data/2010blocks/060630001003028/
6.07E+13,12,1,0,0,0,0,55,68,17,85,80,20,tract_part,http://www.prisonersofthecensus.org/data/2010blocks/060650461021034/
6.07E+13,1987,70,55,8,172,11,3939,6242,1413,7655,81.54147616,18.45852384,tract,http://www.prisonersofthecensus.org/data/2010blocks/060659810001001/
6.07E+13,58,1,1,0,2,0,209,271,94,365,74.24657534,25.75342466,tract,http://www.prisonersofthecensus.org/data/2010blocks/060650455011000/
6.07E+13,1,2,3,1,8,2,25,42,111,153,27.45098039,72.54901961,tract,http://www.prisonersofthecensus.org/data/2010blocks/060650430011026/
6.07E+13,4,1,1,0,7,0,14,27,114,141,19.14893617,80.85106383,tract_part,http://www.prisonersofthecensus.org/data/2010blocks/060650464022010/
6.07E+13,0,0,0,0,0,0,0,0,4,4,0,100,tract_part,http://www.prisonersofthecensus.org/data/2010blocks/060650430081031/
6.07E+13,43,0,1,2,0,1,36,83,33,116,71.55172414,28.44827586,tract_part,http://www.prisonersofthecensus.org/data/2010blocks/060650444022040/
6.07E+13,5,0,0,0,5,1,12,23,6,29,79.31034483,20.68965517,tract,http://www.prisonersofthecensus.org/data/2010blocks/060650402041002/
6.07E+13,207,12,19,1,129,35,490,893,308,1201,74.35470441,25.64529559,tract_part,http://www.prisonersofthecensus.org/data/2010blocks/060650432472009/
6.07E+13,0,0,0,0,0,0,0,0,5,5,0,100,tract_part,http://www.prisonersofthecensus.org/data/2010blocks/060650432571005/
6.07E+13,1516,40,7,1,7,0,1639,3210,1107,4317,74.35719249,25.64280751,tract,http://www.prisonersofthecensus.org/data/2010blocks/060650466011000/
6.07E+13,0,0,0,0,0,0,0,0,3,3,0,100,tract_part,http://www.prisonersofthecensus.org/data/2010blocks/060650429032012/
6.07E+13,2,0,0,0,0,0,0,2,2,4,50,50,tract,http://www.prisonersofthecensus.org/data/2010blocks/060650424072004/
6.07E+13,1,0,4,0,0,0,0,5,1,6,83.33333333,16.66666667,tract,http://www.prisonersofthecensus.org/data/2010blocks/060650425071018/
6.07E+13,8,0,0,0,0,0,0,8,0,8,100,0,tract,http://www.prisonersofthecensus.org/data/2010blocks/060650425132002/
6.07E+13,0,0,0,0,3,0,3,6,0,6,100,0,tract,http://www.prisonersofthecensus.org/data/2010blocks/060650302001026/
6.07E+13,245,12,11,4,6,0,460,738,335,1073,68.77912395,31.22087605,tract,http://www.prisonersofthecensus.org/data/2010blocks/060650303002003/
6.07E+13,9,1,1,0,0,0,17,28,31,59,47.45762712,52.54237288,tract,http://www.prisonersofthecensus.org/data/2010blocks/060650412012001/
6.07E+13,140,0,13,3,27,5,490,678,256,934,72.59100642,27.40899358,tract_part,http://www.prisonersofthecensus.org/data/2010blocks/060650443001026/
6.07E+13,3155,69,111,3,391,1,1721,5451,1316,6767,80.55268213,19.44731787,tract,http://www.prisonersofthecensus.org/data/2010blocks/060679883001000/
6.07E+13,0,0,0,6,0,0,0,6,0,6,100,0,tract,http://www.prisonersofthecensus.org/data/2010blocks/060670096362006/
6.07E+13,643,41,66,8,171,116,555,1600,716,2316,69.08462867,30.91537133,tract,http://www.prisonersofthecensus.org/data/2010blocks/060670007001000/
6.07E+13,4,1,1,0,1,1,8,16,11,27,59.25925926,40.74074074,tract,http://www.prisonersofthecensus.org/data/2010blocks/060670012002017/
6.07E+13,13,1,2,0,0,6,6,28,58,86,32.55813953,67.44186047,tract,http://www.prisonersofthecensus.org/data/2010blocks/060670053011006/
6.07E+13,718,10,46,8,90,23,334,1229,643,1872,65.6517094,34.3482906,tract_part,http://www.prisonersofthecensus.org/data/2010blocks/060670096381054/
6.07E+13,48,0,0,1,0,0,70,119,37,156,76.28205128,23.71794872,tract_part,http://www.prisonersofthecensus.org/data/2010blocks/060710115001124/
6.07E+13,20,2,1,1,27,1,29,81,22,103,78.6407767,21.3592233,tract_part,http://www.prisonersofthecensus.org/data/2010blocks/060710108021198/
6.07E+13,499,100,45,21,291,169,682,1807,706,2513,71.90608834,28.09391166,tract_part,http://www.prisonersofthecensus.org/data/2010blocks/060710019032002/
6.07E+13,705,9,14,0,123,15,684,1550,490,2040,75.98039216,24.01960784,institutionalized,http://www.prisonersofthecensus.org/data/2010blocks/060710122001000/
6.07E+13,682,37,5,4,370,33,1204,2335,870,3205,72.8549142,27.1450858,institutionalized,http://www.prisonersofthecensus.org/data/2010blocks/060710122001009/
6.07E+13,0,0,2,0,0,0,0,2,0,2,100,0,tract,http://www.prisonersofthecensus.org/data/2010blocks/060710001031005/
6.07E+13,762,16,14,2,192,20,1321,2327,773,3100,75.06451613,24.93548387,tract_part,http://www.prisonersofthecensus.org/data/2010blocks/060710022072005/
6.07E+13,280,35,53,20,370,58,800,1616,450,2066,78.21878025,21.78121975,tract_part,http://www.prisonersofthecensus.org/data/2010blocks/060710065004012/
6.07E+13,196,5,6,0,212,20,477,916,237,1153,79.44492628,20.55507372,tract_part,http://www.prisonersofthecensus.org/data/2010blocks/060710027061040/
6.07E+13,235,20,17,0,241,16,509,1038,193,1231,84.32168968,15.67831032,institutionalized,http://www.prisonersofthecensus.org/data/2010blocks/060710091171183/
6.07E+13,163,1,6,0,13,0,399,582,167,749,77.70360481,22.29639519,institutionalized,http://www.prisonersofthecensus.org/data/2010blocks/060710091171188/
6.07E+13,25,3,1,0,17,7,43,96,32,128,75,25,tract_part,http://www.prisonersofthecensus.org/data/2010blocks/060710121011019/
6.07E+13,1458,280,120,52,862,232,1686,4690,889,5579,84.06524467,15.93475533,tract,http://www.prisonersofthecensus.org/data/2010blocks/060719802001169/
6.07E+13,0,0,0,0,7,1,7,15,2,17,88.23529412,11.76470588,tract_part,http://www.prisonersofthecensus.org/data/2010blocks/060710117001084/
6.07E+13,1,0,0,0,0,0,1,2,10,12,16.66666667,83.33333333,tract_part,http://www.prisonersofthecensus.org/data/2010blocks/060730187001567/
6.07E+13,11,2,3,2,17,7,30,72,38,110,65.45454545,34.54545455,tract_part,http://www.prisonersofthecensus.org/data/2010blocks/060730190021008/
6.07E+13,0,0,0,0,0,0,0,0,2,2,0,100,tract_part,http://www.prisonersofthecensus.org/data/2010blocks/060730188021012/
6.07E+13,606,10,139,5,500,8,1214,2482,738,3220,77.08074534,22.91925466,tract_part,http://www.prisonersofthecensus.org/data/2010blocks/060730213021148/
6.07E+13,27,0,1,0,18,0,27,73,26,99,73.73737374,26.26262626,tract_part,http://www.prisonersofthecensus.org/data/2010blocks/060730209021118/
6.07E+13,35,0,1,0,21,1,40,98,23,121,80.99173554,19.00826446,tract_part,http://www.prisonersofthecensus.org/data/2010blocks/060730211002127/
6.07E+13,0,0,5,0,0,0,0,5,0,5,100,0,tract_part,http://www.prisonersofthecensus.org/data/2010blocks/060730207082000/
6.07E+13,1,2,4,0,3,0,3,13,6,19,68.42105263,31.57894737,tract,http://www.prisonersofthecensus.org/data/2010blocks/060730186093007/
6.07E+13,103,15,16,5,152,28,273,592,306,898,65.92427617,34.07572383,tract_part,http://www.prisonersofthecensus.org/data/2010blocks/060730197012008/
6.07E+13,13,4,1,0,19,4,37,78,43,121,64.46280992,35.53719008,tract_part,http://www.prisonersofthecensus.org/data/2010blocks/060730209033368/
6.07E+13,0,0,0,0,0,0,10,10,0,10,100,0,tract,http://www.prisonersofthecensus.org/data/2010blocks/060730123021021/
6.07E+13,77,2,30,8,75,15,215,422,91,513,82.26120858,17.73879142,tract,http://www.prisonersofthecensus.org/data/2010blocks/060730130001000/
6.07E+13,0,0,5,0,0,0,0,5,0,5,100,0,tract,http://www.prisonersofthecensus.org/data/2010blocks/060730133102077/
6.07E+13,4,0,0,0,0,0,1,5,3,8,62.5,37.5,tract,http://www.prisonersofthecensus.org/data/2010blocks/060730033051000/
6.07E+13,0,0,0,0,0,0,0,0,9,9,0,100,tract,http://www.prisonersofthecensus.org/data/2010blocks/060730041002006/
6.07E+13,8,2,8,1,26,5,61,111,36,147,75.51020408,24.48979592,tract,http://www.prisonersofthecensus.org/data/2010blocks/060730050001067/
6.07E+13,16,0,3,2,3,0,9,33,13,46,71.73913043,28.26086957,tract,http://www.prisonersofthecensus.org/data/2010blocks/060730051002064/
6.07E+13,197,7,31,1,95,15,224,570,324,894,63.75838926,36.24161074,institutionalized,http://www.prisonersofthecensus.org/data/2010blocks/060730053003015/
6.07E+13,28,2,5,0,577,5,595,1212,60,1272,95.28301887,4.716981132,institutionalized,http://www.prisonersofthecensus.org/data/2010blocks/060730053003016/
6.07E+13,41,23,27,0,212,74,854,1231,118,1349,91.25277984,8.747220163,institutionalized,http://www.prisonersofthecensus.org/data/2010blocks/060730053003026/
6.07E+13,0,0,3,0,0,4,0,7,14,21,33.33333333,66.66666667,tract,http://www.prisonersofthecensus.org/data/2010blocks/060730083052007/
6.07E+13,4,0,2,0,5,6,13,30,10,40,75,25,tract,http://www.prisonersofthecensus.org/data/2010blocks/060730087011001/
6.07E+13,34,1,7,2,6,3,28,81,162,243,33.33333333,66.66666667,tract_part,http://www.prisonersofthecensus.org/data/2010blocks/060730094001156/
6.07E+13,144,5,27,3,114,3,168,464,265,729,63.64883402,36.35116598,tract,http://www.prisonersofthecensus.org/data/2010blocks/060730166151028/
6.07E+13,1348,61,37,3,1567,45,1681,4742,1377,6119,77.49632293,22.50367707,tract_part,http://www.prisonersofthecensus.org/data/2010blocks/060730100141012/
6.08E+13,18,1,7,2,2,2,8,40,51,91,43.95604396,56.04395604,tract,http://www.prisonersofthecensus.org/data/2010blocks/060750119012001/
6.08E+13,9,2,1,0,2,7,15,36,20,56,64.28571429,35.71428571,tract,http://www.prisonersofthecensus.org/data/2010blocks/060750122021009/
6.08E+13,73,1,18,4,8,11,31,146,61,207,70.53140097,29.46859903,tract,http://www.prisonersofthecensus.org/data/2010blocks/060750125022000/
6.08E+13,0,3,1,0,2,1,9,16,1,17,94.11764706,5.882352941,tract,http://www.prisonersofthecensus.org/data/2010blocks/060750167004005/
6.08E+13,623,24,82,12,41,61,185,1028,275,1303,78.89485802,21.10514198,tract,http://www.prisonersofthecensus.org/data/2010blocks/060750180002006/
6.08E+13,8,0,1,0,0,0,0,9,1,10,90,10,tract,http://www.prisonersofthecensus.org/data/2010blocks/060750264022022/
6.08E+13,16,1,4,1,19,0,20,61,46,107,57.00934579,42.99065421,tract_part,http://www.prisonersofthecensus.org/data/2010blocks/060770015002018/
6.08E+13,86,5,17,2,58,9,97,274,176,450,60.88888889,39.11111111,institutionalized,http://www.prisonersofthecensus.org/data/2010blocks/060770038032005/
6.08E+13,236,13,39,2,161,14,368,833,220,1053,79.10731244,20.89268756,remaining,http://www.prisonersofthecensus.org/data/2010blocks/060770038032009/
6.08E+13,0,0,0,0,0,0,0,0,5,5,0,100,tract_part,http://www.prisonersofthecensus.org/data/2010blocks/060770018001004/
6.08E+13,0,0,0,0,0,0,6,6,0,6,100,0,tract,http://www.prisonersofthecensus.org/data/2010blocks/060770023002013/
6.08E+13,0,0,0,0,6,0,6,12,0,12,100,0,tract,http://www.prisonersofthecensus.org/data/2010blocks/060770033101019/
6.08E+13,979,45,44,2,217,22,1086,2395,1443,3838,62.40229286,37.59770714,tract_part,http://www.prisonersofthecensus.org/data/2010blocks/060770055011028/
6.08E+13,2557,61,20,1,406,6,1881,4932,1521,6453,76.42956764,23.57043236,tract,http://www.prisonersofthecensus.org/data/2010blocks/060790114001000/
6.08E+13,28,0,1,0,27,1,140,197,315,512,38.4765625,61.5234375,tract,http://www.prisonersofthecensus.org/data/2010blocks/060790115042114/
6.08E+13,0,0,0,0,5,0,13,18,0,18,100,0,tract_part,http://www.prisonersofthecensus.org/data/2010blocks/060816137003023/
6.08E+13,0,0,2,0,8,0,8,18,0,18,100,0,tract,http://www.prisonersofthecensus.org/data/2010blocks/060816117003004/
6.08E+13,183,17,82,35,198,82,401,998,207,1205,82.82157676,17.17842324,tract,http://www.prisonersofthecensus.org/data/2010blocks/060816102021046/
6.08E+13,12,4,21,7,23,8,35,110,33,143,76.92307692,23.07692308,tract_part,http://www.prisonersofthecensus.org/data/2010blocks/060816103021053/
6.08E+13,0,0,3,0,0,0,0,3,0,3,100,0,tract,http://www.prisonersofthecensus.org/data/2010blocks/060816019021000/
6.08E+13,26,1,13,2,9,8,58,117,50,167,70.05988024,29.94011976,institutionalized,http://www.prisonersofthecensus.org/data/2010blocks/060830026041018/
6.08E+13,317,55,33,17,289,78,860,1649,208,1857,88.7991384,11.2008616,institutionalized,http://www.prisonersofthecensus.org/data/2010blocks/060830026041019/
6.08E+13,239,31,98,46,273,101,801,1589,485,2074,76.61523626,23.38476374,institutionalized,http://www.prisonersofthecensus.org/data/2010blocks/060830026041027/
6.08E+13,0,0,0,0,0,0,2,2,3,5,40,60,tract,http://www.prisonersofthecensus.org/data/2010blocks/060830027081027/
6.08E+13,0,1,0,0,0,1,2,4,5,9,44.44444444,55.55555556,tract_part,http://www.prisonersofthecensus.org/data/2010blocks/060830026061208/
6.08E+13,0,0,1,0,0,2,3,6,24,30,20,80,tract,http://www.prisonersofthecensus.org/data/2010blocks/060830029243001/
6.08E+13,0,0,0,0,1,0,5,6,6,12,50,50,tract,http://www.prisonersofthecensus.org/data/2010blocks/060830011021004/
6.08E+13,97,23,19,3,198,44,594,978,282,1260,77.61904762,22.38095238,tract_part,http://www.prisonersofthecensus.org/data/2010blocks/060830001012000/
6.08E+13,0,0,0,0,0,0,21,21,6,27,77.77777778,22.22222222,tract_part,http://www.prisonersofthecensus.org/data/2010blocks/060830020132000/
6.08E+13,0,0,0,0,2,0,4,6,0,6,100,0,tract_part,http://www.prisonersofthecensus.org/data/2010blocks/060830022112015/
6.08E+13,0,0,0,0,0,0,4,4,0,4,100,0,tract_part,http://www.prisonersofthecensus.org/data/2010blocks/060830019051122/
6.09E+13,311,30,217,15,970,99,1248,2890,701,3591,80.47897522,19.52102478,tract,http://www.prisonersofthecensus.org/data/2010blocks/060855045043009/
6.09E+13,0,0,0,0,0,0,10,10,0,10,100,0,tract,http://www.prisonersofthecensus.org/data/2010blocks/060855001001016/
6.09E+13,137,13,68,5,361,18,491,1093,179,1272,85.92767296,14.07232704,institutionalized,http://www.prisonersofthecensus.org/data/2010blocks/060855002002000/
6.09E+13,51,9,41,3,262,12,340,718,93,811,88.53267571,11.46732429,institutionalized,http://www.prisonersofthecensus.org/data/2010blocks/060855002002002/
6.09E+13,0,0,0,0,1,1,3,5,1,6,83.33333333,16.66666667,tract,http://www.prisonersofthecensus.org/data/2010blocks/060855013004005/
6.09E+13,0,0,0,0,0,0,4,4,0,4,100,0,tract,http://www.prisonersofthecensus.org/data/2010blocks/060855018002004/
6.09E+13,0,0,0,0,0,0,0,0,3,3,0,100,tract,http://www.prisonersofthecensus.org/data/2010blocks/060855119161011/
6.09E+13,1,0,0,0,2,0,3,6,9,15,40,60,tract,http://www.prisonersofthecensus.org/data/2010blocks/060855053044003/
6.09E+13,0,0,0,0,0,1,1,2,1,3,66.66666667,33.33333333,tract_part,http://www.prisonersofthecensus.org/data/2010blocks/060855087042012/
6.09E+13,0,0,0,0,0,0,0,0,1,1,0,100,tract,http://www.prisonersofthecensus.org/data/2010blocks/060871203023012/
6.09E+13,32,5,5,1,131,6,156,336,153,489,68.71165644,31.28834356,tract_part,http://www.prisonersofthecensus.org/data/2010blocks/060871002006005/
6.09E+13,8,1,0,0,12,0,24,45,39,84,53.57142857,46.42857143,tract_part,http://www.prisonersofthecensus.org/data/2010blocks/060871223001010/
6.09E+13,27,0,0,0,18,2,32,79,53,132,59.84848485,40.15151515,tract_part,http://www.prisonersofthecensus.org/data/2010blocks/060890126011288/
6.09E+13,6,25,2,1,12,13,25,84,154,238,35.29411765,64.70588235,tract,http://www.prisonersofthecensus.org/data/2010blocks/060890101001148/
6.09E+13,0,1,0,0,0,0,0,1,11,12,8.333333333,91.66666667,tract,http://www.prisonersofthecensus.org/data/2010blocks/060890105003015/
6.09E+13,0,1,0,0,1,0,1,3,12,15,20,80,tract_part,http://www.prisonersofthecensus.org/data/2010blocks/060890110023011/
6.09E+13,30,4,6,0,7,1,34,82,55,137,59.8540146,40.1459854,tract_part,http://www.prisonersofthecensus.org/data/2010blocks/060930006001247/
6.10E+13,56,1,2,0,16,10,25,110,30,140,78.57142857,21.42857143,tract_part,http://www.prisonersofthecensus.org/data/2010blocks/060952523172098/
6.10E+13,272,13,22,8,53,37,155,560,211,771,72.63294423,27.36705577,tract_part,http://www.prisonersofthecensus.org/data/2010blocks/060952525022000/
6.10E+13,31,0,2,1,17,1,32,84,45,129,65.11627907,34.88372093,tract_part,http://www.prisonersofthecensus.org/data/2010blocks/060952535001516/
6.10E+13,1152,39,6,2,177,0,498,1874,821,2695,69.53617811,30.46382189,institutionalized,http://www.prisonersofthecensus.org/data/2010blocks/060952530001002/
6.10E+13,2220,67,21,5,433,5,1076,3827,1290,5117,74.78991597,25.21008403,institutionalized,http://www.prisonersofthecensus.org/data/2010blocks/060952530001015/
6.10E+13,4,0,0,0,0,0,0,4,0,4,100,0,tract,http://www.prisonersofthecensus.org/data/2010blocks/060952519011025/
6.10E+13,0,0,0,0,0,0,3,3,13,16,18.75,81.25,tract_part,http://www.prisonersofthecensus.org/data/2010blocks/060971543022017/
6.10E+13,59,35,15,4,48,9,228,398,345,743,53.5666218,46.4333782,tract,http://www.prisonersofthecensus.org/data/2010blocks/060971521001012/
6.10E+13,0,0,0,0,0,0,0,0,3,3,0,100,tract_part,http://www.prisonersofthecensus.org/data/2010blocks/060971530032003/
6.10E+13,21,5,5,3,0,0,66,100,182,282,35.46099291,64.53900709,tract_part,http://www.prisonersofthecensus.org/data/2010blocks/060971527021011/
6.10E+13,0,0,0,0,0,0,0,0,1,1,0,100,tract_part,http://www.prisonersofthecensus.org/data/2010blocks/060971536002005/
6.10E+13,0,0,0,0,2,0,6,8,3,11,72.72727273,27.27272727,tract,http://www.prisonersofthecensus.org/data/2010blocks/060990009102009/
6.10E+13,29,2,13,3,44,7,178,276,140,416,66.34615385,33.65384615,tract_part,http://www.prisonersofthecensus.org/data/2010blocks/060990018003000/
6.10E+13,82,3,9,1,36,7,123,261,326,587,44.46337308,55.53662692,tract_part,http://www.prisonersofthecensus.org/data/2010blocks/060990025012000/
6.10E+13,16,3,1,0,11,1,59,91,82,173,52.60115607,47.39884393,tract_part,http://www.prisonersofthecensus.org/data/2010blocks/060990031001010/
6.10E+13,56,3,8,2,27,3,87,186,147,333,55.85585586,44.14414414,tract_part,http://www.prisonersofthecensus.org/data/2010blocks/061010507021027/
6.10E+13,14,4,16,1,38,7,55,135,99,234,57.69230769,42.30769231,tract,http://www.prisonersofthecensus.org/data/2010blocks/061010506041020/
6.10E+13,0,0,0,0,0,0,0,0,1,1,0,100,tract_part,http://www.prisonersofthecensus.org/data/2010blocks/061030009003040/
6.10E+13,20,5,0,0,17,0,24,66,38,104,63.46153846,36.53846154,tract_part,http://www.prisonersofthecensus.org/data/2010blocks/061030001001445/
6.10E+13,6,13,0,0,16,6,32,73,123,196,37.24489796,62.75510204,tract_part,http://www.prisonersofthecensus.org/data/2010blocks/061030005003087/
6.10E+13,24,1,0,0,15,4,37,81,43,124,65.32258065,34.67741935,tract_part,http://www.prisonersofthecensus.org/data/2010blocks/061030003002408/
6.11E+13,0,2,0,0,0,2,2,6,26,32,18.75,81.25,tract_part,http://www.prisonersofthecensus.org/data/2010blocks/061050001023003/
6.11E+13,25,2,1,1,22,2,45,98,29,127,77.16535433,22.83464567,tract_part,http://www.prisonersofthecensus.org/data/2010blocks/061050001021292/
6.11E+13,0,0,0,0,0,0,0,0,3,3,0,100,tract_part,http://www.prisonersofthecensus.org/data/2010blocks/061070034004029/
6.11E+13,23,1,3,0,21,1,33,82,28,110,74.54545455,25.45454545,tract_part,http://www.prisonersofthecensus.org/data/2010blocks/061070027001023/
6.11E+13,14,13,7,1,24,1,128,188,67,255,73.7254902,26.2745098,tract_part,http://www.prisonersofthecensus.org/data/2010blocks/061070010062006/
6.11E+13,5,0,1,0,4,0,10,20,12,32,62.5,37.5,tract,http://www.prisonersofthecensus.org/data/2010blocks/061070017014013/
6.11E+13,50,18,9,0,258,19,757,1111,283,1394,79.69870875,20.30129125,tract_part,http://www.prisonersofthecensus.org/data/2010blocks/061070009001022/
6.11E+13,1,0,0,0,0,0,0,1,4,5,20,80,tract_part,http://www.prisonersofthecensus.org/data/2010blocks/061070001001146/
6.11E+13,1,10,1,0,6,8,16,42,96,138,30.43478261,69.56521739,tract_part,http://www.prisonersofthecensus.org/data/2010blocks/061090011004013/
6.11E+13,30,1,0,0,45,0,47,123,35,158,77.84810127,22.15189873,tract_part,http://www.prisonersofthecensus.org/data/2010blocks/061090052011019/
6.11E+13,888,47,20,1,1298,33,1359,3646,1107,4753,76.70944667,23.29055333,tract,http://www.prisonersofthecensus.org/data/2010blocks/061099852021005/
6.11E+13,3,0,4,1,11,0,36,55,42,97,56.70103093,43.29896907,institutionalized,http://www.prisonersofthecensus.org/data/2010blocks/061110056001082/
6.11E+13,0,2,0,0,3,0,13,18,0,18,100,0,institutionalized,http://www.prisonersofthecensus.org/data/2010blocks/061110056001102/
6.11E+13,2,1,1,0,0,0,4,8,11,19,42.10526316,57.89473684,institutionalized,http://www.prisonersofthecensus.org/data/2010blocks/061110087003042/
6.11E+13,0,0,0,0,0,0,1,1,2,3,33.33333333,66.66666667,institutionalized,http://www.prisonersofthecensus.org/data/2010blocks/061110087003043/
6.11E+13,0,1,0,0,0,0,0,1,2,3,33.33333333,66.66666667,tract_part,http://www.prisonersofthecensus.org/data/2010blocks/061110075065001/
6.11E+13,0,0,0,0,0,0,0,0,4,4,0,100,tract,http://www.prisonersofthecensus.org/data/2010blocks/061110069002012/
6.11E+13,85,2,21,13,9,0,796,926,487,1413,65.53432413,34.46567587,tract,http://www.prisonersofthecensus.org/data/2010blocks/061110015031016/
6.11E+13,62,1,18,3,1,0,160,245,167,412,59.46601942,40.53398058,tract_part,http://www.prisonersofthecensus.org/data/2010blocks/061130112063008/
6.12E+13,28,27,37,6,25,5,72,200,229,429,46.62004662,53.37995338,tract_part,http://www.prisonersofthecensus.org/data/2010blocks/061150401005057/
8.00E+13,143,57,8,3,200,103,664,1178,431,1609,73.21317589,26.78682411,tract_part,http://www.prisonersofthecensus.org/data/2010blocks/080010086041000/
8.00E+13,51,3,0,0,29,4,74,161,85,246,65.44715447,34.55284553,tract_part,http://www.prisonersofthecensus.org/data/2010blocks/080010088023052/
8.00E+13,27,14,1,1,81,23,250,397,129,526,75.47528517,24.52471483,tract,http://www.prisonersofthecensus.org/data/2010blocks/080010082003015/
8.00E+13,19,4,1,0,5,3,65,97,71,168,57.73809524,42.26190476,tract_part,http://www.prisonersofthecensus.org/data/2010blocks/080039603002039/
8.00E+13,0,1,0,0,0,0,46,47,21,68,69.11764706,30.88235294,tract_part,http://www.prisonersofthecensus.org/data/2010blocks/080039603002032/
8.01E+13,6,0,0,0,0,0,3,9,9,18,50,50,tract,http://www.prisonersofthecensus.org/data/2010blocks/080050810004002/
8.01E+13,374,8,9,0,29,7,125,552,618,1170,47.17948718,52.82051282,tract_part,http://www.prisonersofthecensus.org/data/2010blocks/080050068563023/
8.01E+13,23,4,1,1,12,5,34,80,70,150,53.33333333,46.66666667,tract_part,http://www.prisonersofthecensus.org/data/2010blocks/080050064003021/
8.01E+13,46,4,1,0,6,7,21,85,52,137,62.04379562,37.95620438,tract_part,http://www.prisonersofthecensus.org/data/2010blocks/080050055512018/
8.01E+13,1,0,0,0,5,1,5,12,19,31,38.70967742,61.29032258,tract_part,http://www.prisonersofthecensus.org/data/2010blocks/080079743002014/
8.01E+13,2,1,0,0,0,0,0,3,6,9,33.33333333,66.66666667,tract_part,http://www.prisonersofthecensus.org/data/2010blocks/080099647001053/
8.01E+13,90,14,2,0,4,0,134,244,219,463,52.69978402,47.30021598,institutionalized,http://www.prisonersofthecensus.org/data/2010blocks/080119667002215/
8.01E+13,385,53,22,0,73,18,532,1083,656,1739,62.27717079,37.72282921,institutionalized,http://www.prisonersofthecensus.org/data/2010blocks/080119667005056/
8.01E+13,4,5,1,0,7,5,13,35,31,66,53.03030303,46.96969697,tract,http://www.prisonersofthecensus.org/data/2010blocks/080130122023009/
8.01E+13,0,0,0,0,0,0,0,0,25,25,0,100,tract,http://www.prisonersofthecensus.org/data/2010blocks/080130124013001/
8.01E+13,18,20,3,4,17,13,141,216,243,459,47.05882353,52.94117647,tract_part,http://www.prisonersofthecensus.org/data/2010blocks/080130127071035/
8.01E+13,3,4,1,0,6,1,19,34,48,82,41.46341463,58.53658537,tract,http://www.prisonersofthecensus.org/data/2010blocks/080140311002001/
8.02E+13,243,40,11,0,49,7,444,794,505,1299,61.12394149,38.87605851,tract_part,http://www.prisonersofthecensus.org/data/2010blocks/080150004021081/
8.02E+13,1,0,0,0,0,0,12,13,50,63,20.63492063,79.36507937,tract_part,http://www.prisonersofthecensus.org/data/2010blocks/080150002001060/
8.02E+13,0,0,0,0,0,0,1,1,0,1,100,0,tract_part,http://www.prisonersofthecensus.org/data/2010blocks/080179606003117/
8.02E+13,7,0,1,0,0,0,30,38,28,66,57.57575758,42.42424242,tract_part,http://www.prisonersofthecensus.org/data/2010blocks/080190149001147/
8.02E+13,1,0,0,0,0,0,13,14,10,24,58.33333333,41.66666667,tract_part,http://www.prisonersofthecensus.org/data/2010blocks/080219748002096/
8.03E+13,0,0,0,0,0,0,4,4,6,10,40,60,tract_part,http://www.prisonersofthecensus.org/data/2010blocks/080259696004049/
8.03E+13,204,24,15,0,182,3,299,727,451,1178,61.7147708,38.2852292,institutionalized,http://www.prisonersofthecensus.org/data/2010blocks/080259696001054/
8.03E+13,346,47,26,0,65,1,635,1120,605,1725,64.92753623,35.07246377,institutionalized,http://www.prisonersofthecensus.org/data/2010blocks/080259696003035/
8.03E+13,28,0,3,0,0,0,49,80,70,150,53.33333333,46.66666667,tract_part,http://www.prisonersofthecensus.org/data/2010blocks/080279701003170/
8.03E+13,0,1,0,0,6,2,13,22,31,53,41.50943396,58.49056604,tract_part,http://www.prisonersofthecensus.org/data/2010blocks/080299651002064/
8.03E+13,85,11,6,0,50,10,149,311,210,521,59.69289827,40.30710173,tract_part,http://www.prisonersofthecensus.org/data/2010blocks/080299648003071/
8.03E+13,26,2,0,0,7,1,18,54,21,75,72,28,tract,http://www.prisonersofthecensus.org/data/2010blocks/080310011014014/
8.03E+13,29,0,0,0,3,1,24,57,24,81,70.37037037,29.62962963,tract,http://www.prisonersofthecensus.org/data/2010blocks/080310031021018/
8.03E+13,10,1,0,0,6,6,22,45,6,51,88.23529412,11.76470588,tract,http://www.prisonersofthecensus.org/data/2010blocks/080310035005029/
8.03E+13,15,1,0,0,0,0,3,19,22,41,46.34146341,53.65853659,tract,http://www.prisonersofthecensus.org/data/2010blocks/080310037021003/
8.03E+13,26,2,1,0,6,1,19,55,15,70,78.57142857,21.42857143,tract,http://www.prisonersofthecensus.org/data/2010blocks/080310041011027/
8.03E+13,23,2,0,0,4,4,15,48,21,69,69.56521739,30.43478261,tract,http://www.prisonersofthecensus.org/data/2010blocks/080310041021028/
8.03E+13,806,67,26,0,33,17,1093,2042,1206,3248,62.86945813,37.13054187,tract,http://www.prisonersofthecensus.org/data/2010blocks/080310041061077/
8.03E+13,27,1,1,0,25,2,27,83,26,109,76.14678899,23.85321101,tract,http://www.prisonersofthecensus.org/data/2010blocks/080310041071029/
8.03E+13,17,2,0,0,4,2,22,47,76,123,38.21138211,61.78861789,tract,http://www.prisonersofthecensus.org/data/2010blocks/080310055021045/
8.03E+13,22,5,3,1,14,6,28,79,36,115,68.69565217,31.30434783,tract,http://www.prisonersofthecensus.org/data/2010blocks/080310157001016/
8.04E+13,25,6,6,0,21,11,76,145,172,317,45.74132492,54.25867508,tract_part,http://www.prisonersofthecensus.org/data/2010blocks/080350141232028/
8.04E+13,0,0,1,0,20,1,33,55,20,75,73.33333333,26.66666667,tract_part,http://www.prisonersofthecensus.org/data/2010blocks/080370004033000/
8.04E+13,9,0,0,0,0,0,3,12,23,35,34.28571429,65.71428571,tract_part,http://www.prisonersofthecensus.org/data/2010blocks/080399612091012/
8.04E+13,7,1,0,0,3,2,23,36,38,74,48.64864865,51.35135135,institutionalized,http://www.prisonersofthecensus.org/data/2010blocks/080410003021001/
8.04E+13,39,11,2,2,18,4,50,126,152,278,45.32374101,54.67625899,institutionalized,http://www.prisonersofthecensus.org/data/2010blocks/080410003022042/
8.04E+13,0,0,0,0,0,0,0,0,1,1,0,100,tract,http://www.prisonersofthecensus.org/data/2010blocks/080410027001041/
8.04E+13,265,7,0,13,3,1,363,652,648,1300,50.15384615,49.84615385,tract_part,http://www.prisonersofthecensus.org/data/2010blocks/080410045011033/
8.04E+13,161,8,5,0,20,9,202,405,322,727,55.70839065,44.29160935,institutionalized,http://www.prisonersofthecensus.org/data/2010blocks/080410045011075/
8.04E+13,38,7,1,0,1,1,46,94,111,205,45.85365854,54.14634146,institutionalized,http://www.prisonersofthecensus.org/data/2010blocks/080410045011080/
8.04E+13,12,8,3,0,7,10,43,83,112,195,42.56410256,57.43589744,tract_part,http://www.prisonersofthecensus.org/data/2010blocks/080439784001004/
8.04E+13,205,26,8,0,2,0,248,489,458,947,51.63674762,48.36325238,tract_part,http://www.prisonersofthecensus.org/data/2010blocks/080439801001001/
8.04E+13,82,13,6,0,8,1,190,300,204,504,59.52380952,40.47619048,institutionalized,http://www.prisonersofthecensus.org/data/2010blocks/080439803001001/
8.04E+13,47,14,4,0,0,0,133,198,110,308,64.28571429,35.71428571,institutionalized,http://www.prisonersofthecensus.org/data/2010blocks/080439803001003/
8.04E+13,191,21,7,0,56,4,535,814,480,1294,62.9057187,37.0942813,institutionalized,http://www.prisonersofthecensus.org/data/2010blocks/080439803001005/
8.04E+13,229,41,16,1,28,3,467,785,888,1673,46.92169755,53.07830245,institutionalized,http://www.prisonersofthecensus.org/data/2010blocks/080439803001008/
8.04E+13,45,6,0,0,1,0,79,131,119,250,52.4,47.6,institutionalized,http://www.prisonersofthecensus.org/data/2010blocks/080439803001010/
8.04E+13,886,187,42,0,0,1,842,1958,1152,3110,62.95819936,37.04180064,tract,http://www.prisonersofthecensus.org/data/2010blocks/080439802001000/
8.05E+13,1,3,0,0,10,14,46,74,52,126,58.73015873,41.26984127,tract_part,http://www.prisonersofthecensus.org/data/2010blocks/080459517023001/
8.05E+13,30,5,2,0,22,4,56,119,99,218,54.58715596,45.41284404,tract_part,http://www.prisonersofthecensus.org/data/2010blocks/080459520023036/
8.05E+13,6,0,0,0,1,0,9,16,16,32,50,50,tract_part,http://www.prisonersofthecensus.org/data/2010blocks/080470138004035/
8.05E+13,0,2,0,0,0,1,4,7,27,34,20.58823529,79.41176471,tract_part,http://www.prisonersofthecensus.org/data/2010blocks/080490002022152/
8.05E+13,1,0,0,0,0,0,0,1,2,3,33.33333333,66.66666667,tract_part,http://www.prisonersofthecensus.org/data/2010blocks/080519637004045/
8.06E+13,0,2,0,0,2,0,13,17,1,18,94.44444444,5.555555556,tract_part,http://www.prisonersofthecensus.org/data/2010blocks/080559606003014/
8.06E+13,0,0,0,0,0,1,0,1,0,1,100,0,tract_part,http://www.prisonersofthecensus.org/data/2010blocks/080579556002036/
8.06E+13,71,9,1,3,9,1,383,477,585,1062,44.91525424,55.08474576,tract_part,http://www.prisonersofthecensus.org/data/2010blocks/080590100001023/
8.06E+13,18,7,2,1,6,1,64,99,158,257,38.52140078,61.47859922,tract_part,http://www.prisonersofthecensus.org/data/2010blocks/080590114022002/
8.06E+13,1,0,0,0,4,0,17,22,1,23,95.65217391,4.347826087,tract,http://www.prisonersofthecensus.org/data/2010blocks/080590116011015/
8.06E+13,28,1,2,0,14,1,49,95,70,165,57.57575758,42.42424242,tract_part,http://www.prisonersofthecensus.org/data/2010blocks/080590101003005/
8.06E+13,183,85,26,7,159,34,362,856,471,1327,64.50640543,35.49359457,tract_part,http://www.prisonersofthecensus.org/data/2010blocks/080599804001000/
8.06E+13,203,22,7,0,4,6,364,606,408,1014,59.76331361,40.23668639,institutionalized,http://www.prisonersofthecensus.org/data/2010blocks/080639621001102/
8.06E+13,1,0,0,0,0,0,5,6,14,20,30,70,institutionalized,http://www.prisonersofthecensus.org/data/2010blocks/080639621002062/
8.07E+13,0,0,0,0,9,0,10,19,1,20,95,5,tract_part,http://www.prisonersofthecensus.org/data/2010blocks/080659617006000/
8.07E+13,1,14,0,0,8,2,11,36,26,62,58.06451613,41.93548387,tract_part,http://www.prisonersofthecensus.org/data/2010blocks/080679710001006/
8.07E+13,0,35,0,0,8,6,36,85,54,139,61.15107914,38.84892086,tract_part,http://www.prisonersofthecensus.org/data/2010blocks/080679711001166/
8.07E+13,0,29,0,0,0,1,1,31,0,31,100,0,tract_part,http://www.prisonersofthecensus.org/data/2010blocks/080679403002002/
8.07E+13,31,5,2,0,36,5,227,306,600,906,33.77483444,66.22516556,tract_part,http://www.prisonersofthecensus.org/data/2010blocks/080690016051019/
8.07E+13,0,0,0,0,0,0,0,0,10,10,0,100,tract_part,http://www.prisonersofthecensus.org/data/2010blocks/080690018082054/
8.07E+13,112,17,6,0,0,0,163,298,182,480,62.08333333,37.91666667,tract_part,http://www.prisonersofthecensus.org/data/2010blocks/080710008003015/
8.07E+13,1,3,0,0,8,3,17,32,11,43,74.41860465,25.58139535,tract_part,http://www.prisonersofthecensus.org/data/2010blocks/080710005002012/
8.07E+13,2,2,1,0,0,0,10,15,14,29,51.72413793,48.27586207,tract_part,http://www.prisonersofthecensus.org/data/2010blocks/080739618001017/
8.07E+13,251,22,17,0,0,7,330,627,327,954,65.72327044,34.27672956,tract_part,http://www.prisonersofthecensus.org/data/2010blocks/080739617002112/
8.08E+13,690,94,40,0,75,14,1169,2082,1243,3325,62.61654135,37.38345865,tract_part,http://www.prisonersofthecensus.org/data/2010blocks/080759664002009/
8.08E+13,4,3,0,0,10,1,18,36,37,73,49.31506849,50.68493151,tract_part,http://www.prisonersofthecensus.org/data/2010blocks/080759664001159/
8.08E+13,4,1,0,0,0,0,23,28,154,182,15.38461538,84.61538462,institutionalized,http://www.prisonersofthecensus.org/data/2010blocks/080770008003103/
8.08E+13,1,6,0,0,5,3,18,33,64,97,34.02061856,65.97938144,institutionalized,http://www.prisonersofthecensus.org/data/2010blocks/080770008003104/
8.08E+13,16,14,2,0,28,17,79,156,247,403,38.70967742,61.29032258,tract_part,http://www.prisonersofthecensus.org/data/2010blocks/080770009001199/
8.08E+13,0,0,0,0,1,1,5,7,29,36,19.44444444,80.55555556,tract_part,http://www.prisonersofthecensus.org/data/2010blocks/080810005006017/
8.08E+13,0,24,0,0,0,0,0,24,0,24,100,0,tract_part,http://www.prisonersofthecensus.org/data/2010blocks/080839411001329/
8.09E+13,1,1,0,0,3,0,27,32,87,119,26.8907563,73.1092437,tract_part,http://www.prisonersofthecensus.org/data/2010blocks/080859663005012/
8.09E+13,27,11,4,2,31,14,75,164,98,262,62.59541985,37.40458015,tract_part,http://www.prisonersofthecensus.org/data/2010blocks/080870007001003/
8.09E+13,3,0,0,0,0,0,53,56,42,98,57.14285714,42.85714286,tract_part,http://www.prisonersofthecensus.org/data/2010blocks/080870005003001/
8.09E+13,4,1,0,0,12,0,17,34,52,86,39.53488372,60.46511628,tract_part,http://www.prisonersofthecensus.org/data/2010blocks/080930003001219/
8.10E+13,0,1,0,0,0,1,4,6,12,18,33.33333333,66.66666667,tract_part,http://www.prisonersofthecensus.org/data/2010blocks/080970004012025/
8.10E+13,0,0,0,0,0,0,19,19,16,35,54.28571429,45.71428571,tract_part,http://www.prisonersofthecensus.org/data/2010blocks/080990002002070/
8.10E+13,62,12,2,0,0,0,132,208,229,437,47.597254,52.402746,institutionalized,http://www.prisonersofthecensus.org/data/2010blocks/081010003001002/
8.10E+13,94,19,4,0,34,10,165,326,166,492,66.2601626,33.7398374,remaining,http://www.prisonersofthecensus.org/data/2010blocks/081010003001006/
8.10E+13,9,5,0,0,17,0,57,88,27,115,76.52173913,23.47826087,tract,http://www.prisonersofthecensus.org/data/2010blocks/081010008003000/
8.10E+13,2,0,0,0,0,0,26,28,37,65,43.07692308,56.92307692,tract,http://www.prisonersofthecensus.org/data/2010blocks/081010023002036/
8.10E+13,19,36,1,0,41,63,307,467,174,641,72.8549142,27.1450858,tract,http://www.prisonersofthecensus.org/data/2010blocks/081010035001001/
8.10E+13,0,0,0,0,0,0,4,4,8,12,33.33333333,66.66666667,tract_part,http://www.prisonersofthecensus.org/data/2010blocks/081039511003048/
8.11E+13,0,2,0,0,12,0,12,26,17,43,60.46511628,39.53488372,tract_part,http://www.prisonersofthecensus.org/data/2010blocks/081059768002074/
8.11E+13,0,0,0,0,0,0,3,3,11,14,21.42857143,78.57142857,tract_part,http://www.prisonersofthecensus.org/data/2010blocks/081070004002074/
8.11E+13,0,2,0,0,0,0,9,11,7,18,61.11111111,38.88888889,tract_part,http://www.prisonersofthecensus.org/data/2010blocks/081099776001096/
8.11E+13,0,1,0,0,0,0,2,3,6,9,33.33333333,66.66666667,tract_part,http://www.prisonersofthecensus.org/data/2010blocks/081139681032040/
8.12E+13,0,2,0,0,5,4,13,24,34,58,41.37931034,58.62068966,tract_part,http://www.prisonersofthecensus.org/data/2010blocks/081170004014009/
8.12E+13,12,2,2,0,4,1,6,27,56,83,32.53012048,67.46987952,tract_part,http://www.prisonersofthecensus.org/data/2010blocks/081190101062050/
8.12E+13,24,2,0,0,3,1,40,70,93,163,42.94478528,57.05521472,tract_part,http://www.prisonersofthecensus.org/data/2010blocks/081219242002073/
8.12E+13,5,7,0,0,46,19,114,191,73,264,72.34848485,27.65151515,institutionalized,http://www.prisonersofthecensus.org/data/2010blocks/081230006001007/
8.12E+13,14,21,0,1,65,43,302,446,214,660,67.57575758,32.42424242,remaining,http://www.prisonersofthecensus.org/data/2010blocks/081230006001009/
8.12E+13,81,361,18,9,18,42,31,560,335,895,62.5698324,37.4301676,tract_part,http://www.prisonersofthecensus.org/data/2010blocks/081230019021003/
8.13E+13,0,0,0,0,4,0,4,8,12,20,40,60,institutionalized,http://www.prisonersofthecensus.org/data/2010blocks/081259631003124/
8.13E+13,3,1,0,0,0,0,6,10,65,75,13.33333333,86.66666667,institutionalized,http://www.prisonersofthecensus.org/data/2010blocks/081259631004019/
9.00E+13,6,0,0,0,0,0,1,7,0,7,100,0,tract,http://www.prisonersofthecensus.org/data/2010blocks/090010706001050/
9.00E+13,23,0,0,0,0,1,4,28,1,29,96.55172414,3.448275862,tract,http://www.prisonersofthecensus.org/data/2010blocks/090010709001003/
9.00E+13,4,0,0,0,0,0,0,4,0,4,100,0,institutionalized,http://www.prisonersofthecensus.org/data/2010blocks/090010711001012/
9.00E+13,11,0,0,0,1,0,3,15,2,17,88.23529412,11.76470588,institutionalized,http://www.prisonersofthecensus.org/data/2010blocks/090010711002005/
9.00E+13,347,4,21,44,86,104,286,892,210,1102,80.94373866,19.05626134,tract,http://www.prisonersofthecensus.org/data/2010blocks/090010719002004/
9.00E+13,20,3,0,0,9,4,24,60,37,97,61.8556701,38.1443299,tract,http://www.prisonersofthecensus.org/data/2010blocks/090010737003004/
9.00E+13,30,0,0,0,1,0,14,45,12,57,78.94736842,21.05263158,tract,http://www.prisonersofthecensus.org/data/2010blocks/090010738003007/
9.00E+13,5,0,0,0,1,2,2,10,1,11,90.90909091,9.090909091,tract,http://www.prisonersofthecensus.org/data/2010blocks/090010744002002/
9.00E+13,0,0,2,0,0,0,0,2,0,2,100,0,tract,http://www.prisonersofthecensus.org/data/2010blocks/090012107023002/
9.00E+13,61,1,9,1,16,7,60,155,89,244,63.52459016,36.47540984,institutionalized,http://www.prisonersofthecensus.org/data/2010blocks/090012111001000/
9.00E+13,345,18,33,4,134,73,474,1081,250,1331,81.21712998,18.78287002,institutionalized,http://www.prisonersofthecensus.org/data/2010blocks/090012111001002/
9.00E+13,232,3,2,0,39,12,113,401,261,662,60.57401813,39.42598187,tract,http://www.prisonersofthecensus.org/data/2010blocks/090012305022014/
9.00E+13,5,0,0,0,0,0,4,9,10,19,47.36842105,52.63157895,tract,http://www.prisonersofthecensus.org/data/2010blocks/090010437001000/
9.00E+13,15,0,0,0,3,1,5,24,6,30,80,20,tract,http://www.prisonersofthecensus.org/data/2010blocks/090010441002009/
9.00E+13,20,0,0,0,0,0,22,42,12,54,77.77777778,22.22222222,tract_part,http://www.prisonersofthecensus.org/data/2010blocks/090034712001000/
9.00E+13,735,5,3,0,507,0,548,1798,620,2418,74.35897436,25.64102564,institutionalized,http://www.prisonersofthecensus.org/data/2010blocks/090035243001016/
9.00E+13,640,2,1,0,425,0,446,1514,409,1923,78.73114925,21.26885075,institutionalized,http://www.prisonersofthecensus.org/data/2010blocks/090035243001018/
9.00E+13,5,0,0,0,1,0,4,10,11,21,47.61904762,52.38095238,remaining,http://www.prisonersofthecensus.org/data/2010blocks/090035002001003/
9.00E+13,11,1,0,0,5,0,10,27,7,34,79.41176471,20.58823529,institutionalized,http://www.prisonersofthecensus.org/data/2010blocks/090035002001004/
9.00E+13,6,2,0,0,4,0,10,22,4,26,84.61538462,15.38461538,tract,http://www.prisonersofthecensus.org/data/2010blocks/090035003002003/
9.00E+13,436,0,1,0,346,3,399,1185,289,1474,80.39348711,19.60651289,tract,http://www.prisonersofthecensus.org/data/2010blocks/090035007001015/
9.00E+13,18,0,0,0,11,2,17,48,7,55,87.27272727,12.72727273,tract,http://www.prisonersofthecensus.org/data/2010blocks/090035030001008/
9.00E+13,9,0,0,0,1,0,7,17,5,22,77.27272727,22.72727273,institutionalized,http://www.prisonersofthecensus.org/data/2010blocks/090035246003001/
9.00E+13,27,1,0,0,8,1,18,55,13,68,80.88235294,19.11764706,institutionalized,http://www.prisonersofthecensus.org/data/2010blocks/090035246003004/
9.00E+13,1002,5,12,0,530,1,577,2127,572,2699,78.80696554,21.19303446,tract_part,http://www.prisonersofthecensus.org/data/2010blocks/090034771024022/
9.01E+13,0,0,0,0,0,0,0,0,4,4,0,100,tract_part,http://www.prisonersofthecensus.org/data/2010blocks/090053061004037/
9.01E+13,2,0,0,0,0,0,0,2,5,7,28.57142857,71.42857143,institutionalized,http://www.prisonersofthecensus.org/data/2010blocks/090053102001006/
9.01E+13,1,0,0,0,1,0,1,3,5,8,37.5,62.5,remaining,http://www.prisonersofthecensus.org/data/2010blocks/090053102002015/
9.01E+13,1,0,0,0,1,0,1,3,8,11,27.27272727,72.72727273,tract,http://www.prisonersofthecensus.org/data/2010blocks/090053108031000/
9.01E+13,3,0,0,0,0,0,5,8,6,14,57.14285714,42.85714286,tract,http://www.prisonersofthecensus.org/data/2010blocks/090075415001001/
9.01E+13,743,11,3,0,164,24,363,1308,407,1715,76.26822157,23.73177843,tract_part,http://www.prisonersofthecensus.org/data/2010blocks/090093431011009/
9.01E+13,1,0,0,0,2,0,3,6,0,6,100,0,tract,http://www.prisonersofthecensus.org/data/2010blocks/090091704001012/
9.01E+13,34,0,0,0,0,0,13,47,16,63,74.6031746,25.3968254,tract,http://www.prisonersofthecensus.org/data/2010blocks/090091406002005/
9.01E+13,3,0,0,0,1,0,2,6,1,7,85.71428571,14.28571429,tract,http://www.prisonersofthecensus.org/data/2010blocks/090091409003013/
9.01E+13,353,2,3,0,87,9,236,690,230,920,75,25,tract,http://www.prisonersofthecensus.org/data/2010blocks/090091416002001/
9.01E+13,13,1,0,0,0,0,3,17,12,29,58.62068966,41.37931034,tract,http://www.prisonersofthecensus.org/data/2010blocks/090091422001012/
9.01E+13,17,0,0,0,11,2,13,43,8,51,84.31372549,15.68627451,tract,http://www.prisonersofthecensus.org/data/2010blocks/090093501003003/
9.01E+13,13,0,0,0,7,0,9,29,15,44,65.90909091,34.09090909,tract,http://www.prisonersofthecensus.org/data/2010blocks/090093504003004/
9.01E+13,24,2,0,0,12,3,19,60,22,82,73.17073171,26.82926829,tract,http://www.prisonersofthecensus.org/data/2010blocks/090093508002002/
9.01E+13,20,1,0,0,14,0,16,51,21,72,70.83333333,29.16666667,institutionalized,http://www.prisonersofthecensus.org/data/2010blocks/090093512002002/
9.01E+13,8,0,0,0,1,1,2,12,10,22,54.54545455,45.45454545,institutionalized,http://www.prisonersofthecensus.org/data/2010blocks/090093512003001/
9.01E+13,470,2,2,0,220,0,248,942,180,1122,83.95721925,16.04278075,institutionalized,http://www.prisonersofthecensus.org/data/2010blocks/090117161011000/
9.01E+13,360,4,5,0,191,0,235,795,536,1331,59.72952667,40.27047333,institutionalized,http://www.prisonersofthecensus.org/data/2010blocks/090117161011035/
9.01E+13,6,1,4,0,2,3,7,23,66,89,25.84269663,74.15730337,institutionalized,http://www.prisonersofthecensus.org/data/2010blocks/090119800001027/
9.01E+13,1,0,0,0,0,0,0,1,0,1,100,0,institutionalized,http://www.prisonersofthecensus.org/data/2010blocks/090119800001053/
9.01E+13,8,0,0,0,1,0,2,11,1,12,91.66666667,8.333333333,tract_part,http://www.prisonersofthecensus.org/data/2010blocks/090117027002007/
9.01E+13,602,10,10,0,418,0,443,1483,460,1943,76.3252702,23.6747298,tract_part,http://www.prisonersofthecensus.org/data/2010blocks/090118705021028/
9.01E+13,374,0,3,0,235,0,255,867,394,1261,68.75495638,31.24504362,tract_part,http://www.prisonersofthecensus.org/data/2010blocks/090138813004000/
9.01E+13,942,3,8,0,628,1,669,2251,736,2987,75.35989287,24.64010713,tract,http://www.prisonersofthecensus.org/data/2010blocks/090135381001005/
9.02E+13,170,3,3,0,123,0,130,429,155,584,73.45890411,26.54109589,tract_part,http://www.prisonersofthecensus.org/data/2010blocks/090159051003023/
9.02E+13,1,0,0,0,0,0,0,1,6,7,14.28571429,85.71428571,institutionalized,http://www.prisonersofthecensus.org/data/2010blocks/090158006003008/
9.02E+13,4,1,0,0,2,1,3,11,9,20,55,45,institutionalized,http://www.prisonersofthecensus.org/data/2010blocks/090158006003010/
1.00E+14,106,0,0,0,0,4,3,113,89,202,55.94059406,44.05940594,tract_part,http://www.prisonersofthecensus.org/data/2010blocks/100010414001007/
1.00E+14,38,0,0,0,6,0,6,50,16,66,75.75757576,24.24242424,tract,http://www.prisonersofthecensus.org/data/2010blocks/100030120002022/
1.00E+14,1678,1,1,0,0,1,1,1682,908,2590,64.94208494,35.05791506,tract_part,http://www.prisonersofthecensus.org/data/2010blocks/100030169041000/
1.00E+14,145,0,1,2,0,1,0,149,193,342,43.56725146,56.43274854,tract_part,http://www.prisonersofthecensus.org/data/2010blocks/100030152005033/
1.00E+14,128,0,1,0,9,1,12,151,80,231,65.36796537,34.63203463,tract,http://www.prisonersofthecensus.org/data/2010blocks/100030006011009/
1.00E+14,973,0,0,0,1,2,77,1053,494,1547,68.06722689,31.93277311,tract,http://www.prisonersofthecensus.org/data/2010blocks/100030030023035/
1.00E+14,772,5,5,2,30,15,84,913,651,1564,58.37595908,41.62404092,tract_part,http://www.prisonersofthecensus.org/data/2010blocks/100050505041061/
1.10E+14,4,0,0,0,0,0,0,4,3,7,57.14285714,42.85714286,tract,http://www.prisonersofthecensus.org/data/2010blocks/110010024004006/
1.10E+14,52,0,0,0,0,1,0,53,1,54,98.14814815,1.851851852,tract,http://www.prisonersofthecensus.org/data/2010blocks/110010047011000/
1.10E+14,46,0,1,0,3,9,10,69,11,80,86.25,13.75,tract,http://www.prisonersofthecensus.org/data/2010blocks/110010050022001/
1.10E+14,2739,19,19,1,96,91,272,3237,77,3314,97.67652384,2.323476162,tract,http://www.prisonersofthecensus.org/data/2010blocks/110010068041011/
1.10E+14,260,0,1,0,0,3,4,268,10,278,96.4028777,3.597122302,tract,http://www.prisonersofthecensus.org/data/2010blocks/110010074081000/
1.10E+14,44,2,2,0,0,0,2,50,3,53,94.33962264,5.660377358,tract,http://www.prisonersofthecensus.org/data/2010blocks/110010080011000/
1.10E+14,1,0,0,0,0,0,0,1,0,1,100,0,tract,http://www.prisonersofthecensus.org/data/2010blocks/110010088041006/
1.20E+14,0,0,0,0,0,0,0,0,3,3,0,100,tract_part,http://www.prisonersofthecensus.org/data/2010blocks/120010006003045/
1.20E+14,635,0,1,0,15,3,40,694,298,992,69.95967742,30.04032258,tract_part,http://www.prisonersofthecensus.org/data/2010blocks/120010014003011/
1.20E+14,431,3,0,0,16,2,55,507,424,931,54.4575725,45.5424275,tract_part,http://www.prisonersofthecensus.org/data/2010blocks/120010014001000/
1.20E+14,119,2,1,0,1,0,1,124,147,271,45.75645756,54.24354244,tract_part,http://www.prisonersofthecensus.org/data/2010blocks/120030401012019/
1.20E+14,1,0,0,0,0,0,0,1,2,3,33.33333333,66.66666667,institutionalized,http://www.prisonersofthecensus.org/data/2010blocks/120030402013077/
1.20E+14,924,1,5,0,1,3,30,964,415,1379,69.90572879,30.09427121,institutionalized,http://www.prisonersofthecensus.org/data/2010blocks/120030402013132/
1.20E+14,214,0,0,0,4,2,36,256,602,858,29.83682984,70.16317016,tract_part,http://www.prisonersofthecensus.org/data/2010blocks/120050005001279/
1.20E+14,17,0,0,0,0,0,0,17,50,67,25.37313433,74.62686567,tract_part,http://www.prisonersofthecensus.org/data/2010blocks/120050015012011/
1.20E+14,415,1,0,0,1,1,26,444,538,982,45.21384929,54.78615071,tract_part,http://www.prisonersofthecensus.org/data/2010blocks/120050003003098/
1.20E+14,430,1,2,0,4,1,61,499,337,836,59.68899522,40.31100478,institutionalized,http://www.prisonersofthecensus.org/data/2010blocks/120070004001031/
1.20E+14,671,1,2,0,29,9,121,833,544,1377,60.49382716,39.50617284,institutionalized,http://www.prisonersofthecensus.org/data/2010blocks/120070004003038/
1.20E+14,41,0,0,0,0,0,3,44,53,97,45.36082474,54.63917526,tract_part,http://www.prisonersofthecensus.org/data/2010blocks/120070002005058/
1.20E+14,1130,1,3,1,10,6,230,1381,602,1983,69.64195663,30.35804337,tract_part,http://www.prisonersofthecensus.org/data/2010blocks/120070002004005/
1.20E+14,543,0,0,0,0,1,105,649,964,1613,40.23558586,59.76441414,institutionalized,http://www.prisonersofthecensus.org/data/2010blocks/120090621092003/
1.20E+14,617,0,1,0,1,3,130,752,278,1030,73.00970874,26.99029126,institutionalized,http://www.prisonersofthecensus.org/data/2010blocks/120090621092017/
1.20E+14,247,4,1,0,22,21,111,406,368,774,52.45478036,47.54521964,tract_part,http://www.prisonersofthecensus.org/data/2010blocks/120110703141073/
1.20E+14,185,1,4,0,27,20,143,380,280,660,57.57575758,42.42424242,tract_part,http://www.prisonersofthecensus.org/data/2010blocks/120110104053000/
1.20E+14,825,1,1,0,5,1,116,949,363,1312,72.33231707,27.66768293,tract,http://www.prisonersofthecensus.org/data/2010blocks/120110425001014/
1.20E+14,86,2,0,0,6,1,42,137,76,213,64.31924883,35.68075117,tract_part,http://www.prisonersofthecensus.org/data/2010blocks/120110502083024/
1.20E+14,38,0,0,0,0,0,3,41,35,76,53.94736842,46.05263158,institutionalized,http://www.prisonersofthecensus.org/data/2010blocks/120110801021012/
1.20E+14,76,0,0,0,0,0,7,83,48,131,63.35877863,36.64122137,institutionalized,http://www.prisonersofthecensus.org/data/2010blocks/120110801021036/
1.20E+14,38,0,0,0,3,0,7,48,67,115,41.73913043,58.26086957,tract,http://www.prisonersofthecensus.org/data/2010blocks/120111103412015/
1.20E+14,1574,14,5,0,62,65,366,2086,992,3078,67.77128005,32.22871995,tract_part,http://www.prisonersofthecensus.org/data/2010blocks/120110306003011/
1.20E+14,17,0,0,0,0,0,0,17,41,58,29.31034483,70.68965517,institutionalized,http://www.prisonersofthecensus.org/data/2010blocks/120110308011006/
1.20E+14,81,1,0,0,10,2,29,123,91,214,57.47663551,42.52336449,institutionalized,http://www.prisonersofthecensus.org/data/2010blocks/120110308012022/
1.20E+14,13,0,0,0,0,0,0,13,26,39,33.33333333,66.66666667,tract_part,http://www.prisonersofthecensus.org/data/2010blocks/120130103005074/
1.20E+14,788,2,1,1,26,5,273,1096,571,1667,65.74685063,34.25314937,tract_part,http://www.prisonersofthecensus.org/data/2010blocks/120130103002085/
1.20E+14,671,1,2,0,21,29,131,855,253,1108,77.16606498,22.83393502,tract,http://www.prisonersofthecensus.org/data/2010blocks/120150101001059/
1.20E+14,83,0,0,0,0,1,23,107,429,536,19.96268657,80.03731343,tract_part,http://www.prisonersofthecensus.org/data/2010blocks/120150105012117/
1.20E+14,106,0,0,0,22,0,114,242,302,544,44.48529412,55.51470588,tract_part,http://www.prisonersofthecensus.org/data/2010blocks/120174514001016/
1.20E+14,117,0,0,0,0,0,1,118,350,468,25.21367521,74.78632479,tract_part,http://www.prisonersofthecensus.org/data/2010blocks/120190314002040/
1.20E+14,1,0,0,0,0,0,11,12,0,12,100,0,tract,http://www.prisonersofthecensus.org/data/2010blocks/120210113013019/
1.20E+14,7,0,0,0,0,0,4,11,11,22,50,50,tract_part,http://www.prisonersofthecensus.org/data/2010blocks/120210113022000/
1.20E+14,146,2,3,0,0,1,214,366,498,864,42.36111111,57.63888889,tract,http://www.prisonersofthecensus.org/data/2010blocks/120210106043011/
1.20E+14,93,0,0,0,0,0,12,105,139,244,43.03278689,56.96721311,tract_part,http://www.prisonersofthecensus.org/data/2010blocks/120231102024030/
1.20E+14,49,0,0,0,0,0,1,50,64,114,43.85964912,56.14035088,tract_part,http://www.prisonersofthecensus.org/data/2010blocks/120231105004029/
1.20E+14,1287,8,2,1,11,7,237,1553,992,2545,61.021611,38.978389,tract_part,http://www.prisonersofthecensus.org/data/2010blocks/120231103002032/
1.20E+14,0,0,0,0,0,0,0,0,8,8,0,100,institutionalized,http://www.prisonersofthecensus.org/data/2010blocks/120270102003008/
1.20E+14,48,0,0,0,38,7,44,137,73,210,65.23809524,34.76190476,institutionalized,http://www.prisonersofthecensus.org/data/2010blocks/120270102004023/
1.20E+14,0,0,0,0,12,0,12,24,0,24,100,0,institutionalized,http://www.prisonersofthecensus.org/data/2010blocks/120270102005019/
1.20E+14,0,0,0,0,8,0,8,16,0,16,100,0,tract_part,http://www.prisonersofthecensus.org/data/2010blocks/120270103013058/
1.20E+14,211,0,0,0,31,4,27,273,431,704,38.77840909,61.22159091,institutionalized,http://www.prisonersofthecensus.org/data/2010blocks/120270101021007/
1.20E+14,135,0,0,0,12,0,44,191,109,300,63.66666667,36.33333333,institutionalized,http://www.prisonersofthecensus.org/data/2010blocks/120270101021055/
1.20E+14,775,1,2,0,108,108,307,1301,378,1679,77.48659917,22.51340083,institutionalized,http://www.prisonersofthecensus.org/data/2010blocks/120270101021063/
1.20E+14,0,0,0,0,4,0,4,8,0,8,100,0,institutionalized,http://www.prisonersofthecensus.org/data/2010blocks/120270104041004/
1.20E+14,45,0,0,0,4,1,11,61,39,100,61,39,institutionalized,http://www.prisonersofthecensus.org/data/2010blocks/120270104041089/
1.20E+14,595,1,2,0,7,2,118,725,661,1386,52.30880231,47.69119769,tract_part,http://www.prisonersofthecensus.org/data/2010blocks/120299701011023/
1.20E+14,332,0,1,0,1,1,2,337,256,593,56.8296796,43.1703204,tract,http://www.prisonersofthecensus.org/data/2010blocks/120310103011017/
1.20E+14,56,1,0,0,1,0,8,66,83,149,44.29530201,55.70469799,tract,http://www.prisonersofthecensus.org/data/2010blocks/120310105001002/
1.20E+14,2274,2,5,1,11,1,87,2381,1386,3767,63.20679586,36.79320414,tract,http://www.prisonersofthecensus.org/data/2010blocks/120310010002034/
1.20E+14,8,0,0,0,0,0,1,9,7,16,56.25,43.75,tract,http://www.prisonersofthecensus.org/data/2010blocks/120310021021009/
1.20E+14,51,1,2,0,1,0,4,59,76,135,43.7037037,56.2962963,tract,http://www.prisonersofthecensus.org/data/2010blocks/120310118001006/
1.20E+14,76,0,0,0,0,0,0,76,101,177,42.93785311,57.06214689,tract_part,http://www.prisonersofthecensus.org/data/2010blocks/120330037002008/
1.20E+14,831,23,8,1,44,36,208,1151,575,1726,66.68597914,33.31402086,tract_part,http://www.prisonersofthecensus.org/data/2010blocks/120330040001070/
1.20E+14,335,21,53,0,36,16,383,844,664,1508,55.96816976,44.03183024,tract_part,http://www.prisonersofthecensus.org/data/2010blocks/120330016001012/
1.20E+14,1,0,0,0,0,0,1,2,4,6,33.33333333,66.66666667,tract_part,http://www.prisonersofthecensus.org/data/2010blocks/120330024001048/
1.20E+14,253,5,14,0,31,8,172,483,230,713,67.74193548,32.25806452,tract_part,http://www.prisonersofthecensus.org/data/2010blocks/120330033051008/
1.20E+14,54,0,0,0,0,0,12,66,99,165,40,60,tract_part,http://www.prisonersofthecensus.org/data/2010blocks/120350602073079/
1.20E+14,29,0,3,0,0,0,3,35,103,138,25.36231884,74.63768116,tract,http://www.prisonersofthecensus.org/data/2010blocks/120350601032025/
1.20E+14,143,0,0,0,1,1,15,160,121,281,56.93950178,43.06049822,tract_part,http://www.prisonersofthecensus.org/data/2010blocks/120379703021063/
1.20E+14,689,4,2,0,13,4,215,927,519,1446,64.10788382,35.89211618,tract_part,http://www.prisonersofthecensus.org/data/2010blocks/120379701003088/
1.20E+14,22,0,0,0,0,0,1,23,38,61,37.70491803,62.29508197,tract_part,http://www.prisonersofthecensus.org/data/2010blocks/120379702001482/
1.20E+14,88,0,0,0,1,0,5,94,39,133,70.67669173,29.32330827,institutionalized,http://www.prisonersofthecensus.org/data/2010blocks/120390204002023/
1.20E+14,191,0,1,0,0,5,14,211,157,368,57.33695652,42.66304348,institutionalized,http://www.prisonersofthecensus.org/data/2010blocks/120390204002038/
1.20E+14,82,1,0,0,0,3,9,95,109,204,46.56862745,53.43137255,institutionalized,http://www.prisonersofthecensus.org/data/2010blocks/120390204002041/
1.20E+14,5,0,0,0,0,0,0,5,0,5,100,0,tract_part,http://www.prisonersofthecensus.org/data/2010blocks/120390205003020/
1.20E+14,318,0,3,0,1,10,50,382,207,589,64.85568761,35.14431239,tract_part,http://www.prisonersofthecensus.org/data/2010blocks/120390207022048/
1.20E+14,2,0,0,0,0,0,0,2,28,30,6.666666667,93.33333333,tract_part,http://www.prisonersofthecensus.org/data/2010blocks/120419502042015/
1.20E+14,240,4,6,0,11,0,77,338,184,522,64.75095785,35.24904215,institutionalized,http://www.prisonersofthecensus.org/data/2010blocks/120430003001002/
1.20E+14,581,0,0,0,0,0,41,622,356,978,63.599182,36.400818,institutionalized,http://www.prisonersofthecensus.org/data/2010blocks/120430003001022/
1.20E+14,7,0,0,0,0,0,0,7,34,41,17.07317073,82.92682927,tract_part,http://www.prisonersofthecensus.org/data/2010blocks/120459603002090/
1.20E+14,116,0,0,0,1,0,33,150,125,275,54.54545455,45.45454545,tract_part,http://www.prisonersofthecensus.org/data/2010blocks/120459603001147/
1.20E+14,680,1,2,1,28,7,167,886,599,1485,59.66329966,40.33670034,institutionalized,http://www.prisonersofthecensus.org/data/2010blocks/120459601004045/
1.20E+14,766,2,1,0,24,3,211,1007,591,1598,63.01627034,36.98372966,institutionalized,http://www.prisonersofthecensus.org/data/2010blocks/120459601004054/
1.20E+14,1587,6,4,0,45,7,330,1979,964,2943,67.24430853,32.75569147,institutionalized,http://www.prisonersofthecensus.org/data/2010blocks/120479601002027/
1.20E+14,43,0,0,0,0,0,1,44,16,60,73.33333333,26.66666667,institutionalized,http://www.prisonersofthecensus.org/data/2010blocks/120479601003044/
1.21E+14,336,0,0,0,15,0,582,933,708,1641,56.85557587,43.14442413,tract_part,http://www.prisonersofthecensus.org/data/2010blocks/120499703005039/
1.21E+14,0,0,0,0,0,0,9,9,0,9,100,0,tract_part,http://www.prisonersofthecensus.org/data/2010blocks/120510001002039/
1.21E+14,635,2,2,0,13,5,250,907,361,1268,71.52996845,28.47003155,tract_part,http://www.prisonersofthecensus.org/data/2010blocks/120510006001142/
1.21E+14,60,0,0,0,0,0,84,144,43,187,77.00534759,22.99465241,tract_part,http://www.prisonersofthecensus.org/data/2010blocks/120510004024012/
1.21E+14,0,0,0,0,0,0,4,4,0,4,100,0,tract_part,http://www.prisonersofthecensus.org/data/2010blocks/120510004012040/
1.21E+14,239,3,1,1,5,5,41,295,658,953,30.95487933,69.04512067,tract_part,http://www.prisonersofthecensus.org/data/2010blocks/120530409111000/
1.21E+14,0,0,3,0,0,0,0,3,0,3,100,0,tract,http://www.prisonersofthecensus.org/data/2010blocks/120530411053026/
1.21E+14,1,0,0,0,0,0,0,1,0,1,100,0,tract_part,http://www.prisonersofthecensus.org/data/2010blocks/120530412011025/
1.21E+14,0,0,0,0,1,0,5,6,0,6,100,0,tract_part,http://www.prisonersofthecensus.org/data/2010blocks/120559617001009/
1.21E+14,105,0,0,0,0,1,74,180,205,385,46.75324675,53.24675325,tract,http://www.prisonersofthecensus.org/data/2010blocks/120559608003060/
1.21E+14,1120,0,2,0,0,0,446,1568,807,2375,66.02105263,33.97894737,tract_part,http://www.prisonersofthecensus.org/data/2010blocks/120570122111010/
1.21E+14,8,0,0,0,3,1,7,19,11,30,63.33333333,36.66666667,tract,http://www.prisonersofthecensus.org/data/2010blocks/120570026001001/
1.21E+14,360,9,6,0,38,36,248,697,289,986,70.68965517,29.31034483,tract,http://www.prisonersofthecensus.org/data/2010blocks/120570037001000/
1.21E+14,0,0,0,0,0,0,0,0,4,4,0,100,tract_part,http://www.prisonersofthecensus.org/data/2010blocks/120570102122004/
1.21E+14,80,0,0,0,1,0,12,93,195,288,32.29166667,67.70833333,tract,http://www.prisonersofthecensus.org/data/2010blocks/120570139161069/
1.21E+14,5,0,0,0,1,0,1,7,77,84,8.333333333,91.66666667,institutionalized,http://www.prisonersofthecensus.org/data/2010blocks/120599604005014/
1.21E+14,697,3,4,0,0,3,108,815,571,1386,58.8023088,41.1976912,institutionalized,http://www.prisonersofthecensus.org/data/2010blocks/120599604005020/
1.21E+14,120,0,0,0,2,2,38,162,323,485,33.40206186,66.59793814,tract_part,http://www.prisonersofthecensus.org/data/2010blocks/120610502003000/
1.21E+14,919,1,1,0,16,4,163,1104,801,1905,57.95275591,42.04724409,tract_part,http://www.prisonersofthecensus.org/data/2010blocks/120632103002002/
1.21E+14,705,43,16,1,67,36,299,1167,421,1588,73.48866499,26.51133501,tract_part,http://www.prisonersofthecensus.org/data/2010blocks/120632108003041/
1.21E+14,757,4,27,2,44,34,223,1091,425,1516,71.96569921,28.03430079,tract_part,http://www.prisonersofthecensus.org/data/2010blocks/120632101002028/
1.21E+14,103,5,1,0,2,6,12,129,101,230,56.08695652,43.91304348,tract_part,http://www.prisonersofthecensus.org/data/2010blocks/120632106002017/
1.21E+14,569,1,2,0,33,4,121,730,469,1199,60.88407006,39.11592994,institutionalized,http://www.prisonersofthecensus.org/data/2010blocks/120632109002039/
1.21E+14,351,2,3,0,10,4,63,433,464,897,48.27201784,51.72798216,institutionalized,http://www.prisonersofthecensus.org/data/2010blocks/120632109002054/
1.21E+14,32,0,0,0,1,0,1,34,11,45,75.55555556,24.44444444,institutionalized,http://www.prisonersofthecensus.org/data/2010blocks/120652501012057/
1.21E+14,552,2,1,0,12,4,84,655,516,1171,55.93509821,44.06490179,institutionalized,http://www.prisonersofthecensus.org/data/2010blocks/120652501013002/
1.21E+14,2,0,0,0,0,0,1,3,0,3,100,0,institutionalized,http://www.prisonersofthecensus.org/data/2010blocks/120652501013003/
1.21E+14,78,0,0,0,0,0,14,92,56,148,62.16216216,37.83783784,institutionalized,http://www.prisonersofthecensus.org/data/2010blocks/120679601001170/
1.21E+14,973,3,2,1,3,15,208,1205,682,1887,63.85797562,36.14202438,institutionalized,http://www.prisonersofthecensus.org/data/2010blocks/120679601001185/
1.21E+14,5,0,0,0,0,0,1,6,12,18,33.33333333,66.66666667,tract_part,http://www.prisonersofthecensus.org/data/2010blocks/120679602002156/
1.21E+14,487,1,1,0,29,1,92,611,557,1168,52.31164384,47.68835616,tract_part,http://www.prisonersofthecensus.org/data/2010blocks/120690312042139/
1.21E+14,299,10,0,0,23,18,106,456,475,931,48.97959184,51.02040816,tract_part,http://www.prisonersofthecensus.org/data/2010blocks/120690308034054/
1.21E+14,3,0,0,0,0,0,0,3,2,5,60,40,tract,http://www.prisonersofthecensus.org/data/2010blocks/120710007002020/
1.21E+14,370,1,0,0,0,1,150,522,810,1332,39.18918919,60.81081081,tract_part,http://www.prisonersofthecensus.org/data/2010blocks/120710012012002/
1.21E+14,183,0,0,0,0,0,72,255,252,507,50.29585799,49.70414201,tract,http://www.prisonersofthecensus.org/data/2010blocks/120710803002034/
1.21E+14,6,0,0,0,0,0,5,11,9,20,55,45,tract_part,http://www.prisonersofthecensus.org/data/2010blocks/120710019062057/
1.21E+14,34,0,0,0,0,0,15,49,17,66,74.24242424,25.75757576,institutionalized,http://www.prisonersofthecensus.org/data/2010blocks/120730025093001/
1.21E+14,315,22,11,2,69,52,305,776,318,1094,70.93235832,29.06764168,institutionalized,http://www.prisonersofthecensus.org/data/2010blocks/120730025093004/
1.21E+14,7,0,0,0,3,1,6,17,5,22,77.27272727,22.72727273,tract_part,http://www.prisonersofthecensus.org/data/2010blocks/120730026042001/
1.21E+14,55,0,0,0,1,0,6,62,26,88,70.45454545,29.54545455,tract_part,http://www.prisonersofthecensus.org/data/2010blocks/120730019011024/
1.21E+14,673,3,1,0,6,10,29,722,211,933,77.38478028,22.61521972,tract_part,http://www.prisonersofthecensus.org/data/2010blocks/120730020031050/
1.21E+14,75,1,2,0,0,1,8,87,140,227,38.32599119,61.67400881,tract_part,http://www.prisonersofthecensus.org/data/2010blocks/120759704003000/
1.21E+14,0,0,0,0,0,0,0,0,15,15,0,100,tract_part,http://www.prisonersofthecensus.org/data/2010blocks/120759706002012/
1.21E+14,61,0,0,0,0,0,7,68,115,183,37.15846995,62.84153005,tract_part,http://www.prisonersofthecensus.org/data/2010blocks/120759701021088/
1.21E+14,17,0,1,0,1,0,1,20,42,62,32.25806452,67.74193548,tract_part,http://www.prisonersofthecensus.org/data/2010blocks/120779502001146/
1.21E+14,848,2,5,0,28,3,197,1083,656,1739,62.27717079,37.72282921,tract_part,http://www.prisonersofthecensus.org/data/2010blocks/120779502001073/
1.21E+14,48,0,0,0,0,0,2,50,28,78,64.1025641,35.8974359,tract_part,http://www.prisonersofthecensus.org/data/2010blocks/120791103022049/
1.21E+14,741,3,3,0,43,1,214,1005,494,1499,67.04469646,32.95530354,tract_part,http://www.prisonersofthecensus.org/data/2010blocks/120791103021047/
1.21E+14,0,0,0,0,0,0,0,0,2,2,0,100,tract_part,http://www.prisonersofthecensus.org/data/2010blocks/120810006031015/
1.21E+14,37,1,0,0,0,0,7,45,75,120,37.5,62.5,tract,http://www.prisonersofthecensus.org/data/2010blocks/120810008051037/
1.21E+14,0,0,0,0,0,0,17,17,1,18,94.44444444,5.555555556,tract_part,http://www.prisonersofthecensus.org/data/2010blocks/120810015023030/
1.21E+14,352,0,0,0,0,0,164,516,528,1044,49.42528736,50.57471264,tract,http://www.prisonersofthecensus.org/data/2010blocks/120810016021002/
1.21E+14,2,0,0,0,0,0,0,2,0,2,100,0,tract,http://www.prisonersofthecensus.org/data/2010blocks/120830010051024/
1.21E+14,746,2,4,1,45,4,179,981,665,1646,59.59902795,40.40097205,institutionalized,http://www.prisonersofthecensus.org/data/2010blocks/120830003013006/
1.21E+14,993,2,5,0,29,12,138,1179,1578,2757,42.76387378,57.23612622,institutionalized,http://www.prisonersofthecensus.org/data/2010blocks/120830003013018/
1.21E+14,11,0,0,0,0,0,0,11,20,31,35.48387097,64.51612903,institutionalized,http://www.prisonersofthecensus.org/data/2010blocks/120830014013085/
1.21E+14,40,2,0,0,0,1,5,48,59,107,44.85981308,55.14018692,institutionalized,http://www.prisonersofthecensus.org/data/2010blocks/120830014013087/
1.21E+14,579,0,1,0,3,1,25,609,1066,1675,36.35820896,63.64179104,tract,http://www.prisonersofthecensus.org/data/2010blocks/120830016001004/
1.21E+14,4,0,0,0,0,0,0,4,29,33,12.12121212,87.87878788,tract,http://www.prisonersofthecensus.org/data/2010blocks/120830013021040/
1.21E+14,82,0,0,0,0,0,23,105,72,177,59.3220339,40.6779661,tract_part,http://www.prisonersofthecensus.org/data/2010blocks/120850018013000/
1.21E+14,862,0,1,0,6,8,246,1123,426,1549,72.49838606,27.50161394,tract,http://www.prisonersofthecensus.org/data/2010blocks/120850018021011/
1.21E+14,149,0,1,0,0,5,76,231,402,633,36.492891,63.507109,tract_part,http://www.prisonersofthecensus.org/data/2010blocks/120850010003013/
1.21E+14,1,0,0,0,0,0,3,4,0,4,100,0,tract_part,http://www.prisonersofthecensus.org/data/2010blocks/120860110013033/
1.21E+14,252,3,0,0,38,3,77,373,332,705,52.90780142,47.09219858,institutionalized,http://www.prisonersofthecensus.org/data/2010blocks/120860114041000/
1.21E+14,28,1,0,0,0,6,16,51,14,65,78.46153846,21.53846154,institutionalized,http://www.prisonersofthecensus.org/data/2010blocks/120860114043182/
1.21E+14,1741,2,3,0,2,60,894,2702,619,3321,81.36103583,18.63896417,tract_part,http://www.prisonersofthecensus.org/data/2010blocks/120860141001010/
1.21E+14,965,4,0,0,8,14,340,1331,372,1703,78.15619495,21.84380505,tract,http://www.prisonersofthecensus.org/data/2010blocks/120860151001013/
1.21E+14,481,3,10,3,50,27,630,1204,258,1462,82.35294118,17.64705882,tract_part,http://www.prisonersofthecensus.org/data/2010blocks/120860202003059/
1.21E+14,2,0,0,0,0,0,1,3,1,4,75,25,tract,http://www.prisonersofthecensus.org/data/2010blocks/120860081022002/
1.21E+14,25,0,0,0,0,2,21,48,5,53,90.56603774,9.433962264,tract,http://www.prisonersofthecensus.org/data/2010blocks/120860020031010/
1.21E+14,20,0,0,0,0,0,6,26,6,32,81.25,18.75,tract,http://www.prisonersofthecensus.org/data/2010blocks/120860029001015/
1.21E+14,629,9,1,0,0,14,349,1002,63,1065,94.08450704,5.915492958,tract,http://www.prisonersofthecensus.org/data/2010blocks/120860030042029/
1.21E+14,109,1,1,0,1,16,69,197,30,227,86.78414097,13.21585903,tract,http://www.prisonersofthecensus.org/data/2010blocks/120860031002033/
1.21E+14,621,1,3,0,5,6,740,1376,263,1639,83.95363026,16.04636974,tract,http://www.prisonersofthecensus.org/data/2010blocks/120860037061012/
1.21E+14,0,0,0,0,1,0,1,2,0,2,100,0,tract,http://www.prisonersofthecensus.org/data/2010blocks/120860053023001/
1.21E+14,3,0,0,0,0,0,0,3,0,3,100,0,tract_part,http://www.prisonersofthecensus.org/data/2010blocks/120860002041049/
1.21E+14,77,0,0,0,4,0,28,109,47,156,69.87179487,30.12820513,tract_part,http://www.prisonersofthecensus.org/data/2010blocks/120860005052015/
1.21E+14,565,0,0,0,0,0,405,970,100,1070,90.65420561,9.345794393,institutionalized,http://www.prisonersofthecensus.org/data/2010blocks/120860091002136/
1.21E+14,595,1,0,0,2,0,423,1021,149,1170,87.26495726,12.73504274,institutionalized,http://www.prisonersofthecensus.org/data/2010blocks/120860091002137/
1.21E+14,81,2,0,0,0,1,86,170,184,354,48.02259887,51.97740113,tract_part,http://www.prisonersofthecensus.org/data/2010blocks/120879719001011/
1.21E+14,0,0,0,0,0,0,2,2,1,3,66.66666667,33.33333333,tract_part,http://www.prisonersofthecensus.org/data/2010blocks/120879718003003/
1.21E+14,0,0,0,0,0,1,1,2,27,29,6.896551724,93.10344828,institutionalized,http://www.prisonersofthecensus.org/data/2010blocks/120879714011011/
1.21E+14,29,1,0,0,0,1,19,50,19,69,72.46376812,27.53623188,institutionalized,http://www.prisonersofthecensus.org/data/2010blocks/120879714012066/
1.21E+14,0,0,0,0,0,0,8,8,6,14,57.14285714,42.85714286,tract_part,http://www.prisonersofthecensus.org/data/2010blocks/120879710012076/
1.21E+14,0,0,0,0,0,0,1,1,4,5,20,80,institutionalized,http://www.prisonersofthecensus.org/data/2010blocks/120879708003003/
1.21E+14,9,0,0,0,0,0,9,18,15,33,54.54545455,45.45454545,remaining,http://www.prisonersofthecensus.org/data/2010blocks/120879708003004/
1.21E+14,49,0,0,0,0,1,2,52,144,196,26.53061224,73.46938776,tract_part,http://www.prisonersofthecensus.org/data/2010blocks/120890503012094/
1.21E+14,145,1,2,0,0,1,18,167,336,503,33.20079523,66.79920477,tract_part,http://www.prisonersofthecensus.org/data/2010blocks/120910204002024/
1.21E+14,726,0,5,0,13,5,105,854,504,1358,62.88659794,37.11340206,tract,http://www.prisonersofthecensus.org/data/2010blocks/120910203021197/
1.21E+14,963,2,2,0,20,14,331,1332,414,1746,76.28865979,23.71134021,tract,http://www.prisonersofthecensus.org/data/2010blocks/120939101011012/
1.21E+14,39,6,0,0,13,0,60,118,127,245,48.16326531,51.83673469,tract_part,http://www.prisonersofthecensus.org/data/2010blocks/120939102023064/
1.21E+14,78,0,0,0,1,0,18,97,60,157,61.78343949,38.21656051,tract_part,http://www.prisonersofthecensus.org/data/2010blocks/120950185003042/
1.21E+14,1798,1,3,0,0,1,635,2438,1085,3523,69.20238433,30.79761567,tract_part,http://www.prisonersofthecensus.org/data/2010blocks/120950145041010/
1.21E+14,932,3,6,0,18,1,227,1187,1218,2405,49.35550936,50.64449064,tract_part,http://www.prisonersofthecensus.org/data/2010blocks/120950167311065/
1.21E+14,43,0,0,0,0,0,20,63,88,151,41.7218543,58.2781457,tract_part,http://www.prisonersofthecensus.org/data/2010blocks/120970416001002/
1.21E+14,38,0,0,0,1,3,26,68,49,117,58.11965812,41.88034188,tract_part,http://www.prisonersofthecensus.org/data/2010blocks/120970423003053/
1.21E+14,0,0,0,0,0,0,29,29,2,31,93.5483871,6.451612903,tract_part,http://www.prisonersofthecensus.org/data/2010blocks/120970423002022/
1.21E+14,310,0,0,0,0,2,382,694,472,1166,59.51972556,40.48027444,tract_part,http://www.prisonersofthecensus.org/data/2010blocks/120970429001088/
1.21E+14,71,0,0,0,8,2,15,96,51,147,65.30612245,34.69387755,tract_part,http://www.prisonersofthecensus.org/data/2010blocks/120990080011099/
1.21E+14,990,2,15,0,45,44,397,1493,472,1965,75.97964377,24.02035623,tract_part,http://www.prisonersofthecensus.org/data/2010blocks/120990083022033/
1.21E+14,89,0,0,0,0,0,6,95,23,118,80.50847458,19.49152542,institutionalized,http://www.prisonersofthecensus.org/data/2010blocks/120990081011124/
1.21E+14,175,0,2,0,2,0,12,191,80,271,70.4797048,29.5202952,institutionalized,http://www.prisonersofthecensus.org/data/2010blocks/120990081013000/
1.21E+14,392,0,16,0,5,1,58,472,214,686,68.80466472,31.19533528,tract_part,http://www.prisonersofthecensus.org/data/2010blocks/120990081021005/
1.21E+14,1013,0,0,0,0,4,235,1252,731,1983,63.13666162,36.86333838,tract_part,http://www.prisonersofthecensus.org/data/2010blocks/120990038002008/
1.21E+14,3,0,0,0,0,0,0,3,3,6,50,50,tract_part,http://www.prisonersofthecensus.org/data/2010blocks/120990009052001/
1.21E+14,0,0,1,0,0,0,0,1,5,6,16.66666667,83.33333333,tract,http://www.prisonersofthecensus.org/data/2010blocks/120990078211001/
1.21E+14,60,0,0,0,0,0,6,66,26,92,71.73913043,28.26086957,institutionalized,http://www.prisonersofthecensus.org/data/2010blocks/120990078181021/
1.21E+14,318,0,1,2,0,9,79,409,534,943,43.37221633,56.62778367,institutionalized,http://www.prisonersofthecensus.org/data/2010blocks/120990078181025/
1.21E+14,151,1,1,0,21,0,80,254,1022,1276,19.90595611,80.09404389,tract_part,http://www.prisonersofthecensus.org/data/2010blocks/121010319021013/
1.21E+14,241,2,0,1,0,2,52,298,359,657,45.35768645,54.64231355,tract_part,http://www.prisonersofthecensus.org/data/2010blocks/121010329041029/
1.21E+14,1,0,1,0,0,0,0,2,0,2,100,0,tract_part,http://www.prisonersofthecensus.org/data/2010blocks/121030267024001/
1.21E+14,52,0,0,0,1,0,7,60,46,106,56.60377358,43.39622642,tract_part,http://www.prisonersofthecensus.org/data/2010blocks/121030245101013/
1.21E+14,1187,0,30,2,51,2,231,1503,1683,3186,47.17514124,52.82485876,tract_part,http://www.prisonersofthecensus.org/data/2010blocks/121030245103006/
1.21E+14,2,0,0,0,0,0,0,2,8,10,20,80,tract_part,http://www.prisonersofthecensus.org/data/2010blocks/121030254081001/
1.21E+14,18,0,0,0,0,0,5,23,81,104,22.11538462,77.88461538,tract_part,http://www.prisonersofthecensus.org/data/2010blocks/121030248031005/
1.21E+14,62,0,2,0,0,0,9,73,74,147,49.65986395,50.34013605,tract,http://www.prisonersofthecensus.org/data/2010blocks/121030208002004/
1.21E+14,15,0,0,0,1,0,1,17,57,74,22.97297297,77.02702703,tract,http://www.prisonersofthecensus.org/data/2010blocks/121030212003030/
1.21E+14,48,0,0,0,0,0,7,55,103,158,34.81012658,65.18987342,tract_part,http://www.prisonersofthecensus.org/data/2010blocks/121030244112002/
1.21E+14,29,1,0,0,4,1,14,49,41,90,54.44444444,45.55555556,tract_part,http://www.prisonersofthecensus.org/data/2010blocks/121030273081056/
1.21E+14,25,0,0,0,0,0,7,32,47,79,40.50632911,59.49367089,tract_part,http://www.prisonersofthecensus.org/data/2010blocks/121050150001014/
1.21E+14,131,0,0,0,35,5,159,330,477,807,40.89219331,59.10780669,tract_part,http://www.prisonersofthecensus.org/data/2010blocks/121050152002007/
1.21E+14,470,2,2,0,16,3,179,672,543,1215,55.30864198,44.69135802,institutionalized,http://www.prisonersofthecensus.org/data/2010blocks/121050157023097/
1.21E+14,89,0,1,0,1,0,16,107,71,178,60.11235955,39.88764045,institutionalized,http://www.prisonersofthecensus.org/data/2010blocks/121050157023244/
1.21E+14,511,1,3,1,35,17,167,735,667,1402,52.42510699,47.57489301,tract,http://www.prisonersofthecensus.org/data/2010blocks/121050158021006/
1.21E+14,878,0,3,3,17,6,162,1069,806,1875,57.01333333,42.98666667,tract_part,http://www.prisonersofthecensus.org/data/2010blocks/121050124041019/
1.21E+14,3,0,0,0,1,2,1,7,43,50,14,86,tract_part,http://www.prisonersofthecensus.org/data/2010blocks/121050132002036/
1.21E+14,213,0,0,0,0,1,32,246,208,454,54.18502203,45.81497797,tract_part,http://www.prisonersofthecensus.org/data/2010blocks/121079510001055/
1.21E+14,130,0,0,0,0,0,0,130,181,311,41.80064309,58.19935691,tract_part,http://www.prisonersofthecensus.org/data/2010blocks/121079506003078/
1.21E+14,120,4,3,0,1,10,19,157,317,474,33.12236287,66.87763713,tract_part,http://www.prisonersofthecensus.org/data/2010blocks/121090209012115/
1.21E+14,5,0,0,0,0,0,0,5,3,8,62.5,37.5,tract,http://www.prisonersofthecensus.org/data/2010blocks/121113805004016/
1.21E+14,66,0,0,0,0,1,5,72,61,133,54.13533835,45.86466165,tract_part,http://www.prisonersofthecensus.org/data/2010blocks/121113814023012/
1.21E+14,603,1,0,0,10,2,90,706,757,1463,48.25700615,51.74299385,tract_part,http://www.prisonersofthecensus.org/data/2010blocks/121113808001055/
1.21E+14,66,0,0,0,0,1,7,74,54,128,57.8125,42.1875,tract_part,http://www.prisonersofthecensus.org/data/2010blocks/121130101001101/
1.21E+14,1672,2,4,2,13,1,253,1947,877,2824,68.94475921,31.05524079,institutionalized,http://www.prisonersofthecensus.org/data/2010blocks/121130108081013/
1.21E+14,79,0,6,0,0,0,14,99,330,429,23.07692308,76.92307692,institutionalized,http://www.prisonersofthecensus.org/data/2010blocks/121130108081016/
1.21E+14,223,0,0,0,1,4,81,309,533,842,36.69833729,63.30166271,tract,http://www.prisonersofthecensus.org/data/2010blocks/121150001023002/
1.21E+14,295,3,0,0,4,11,86,399,371,770,51.81818182,48.18181818,tract_part,http://www.prisonersofthecensus.org/data/2010blocks/121170208033013/
1.21E+14,93,1,0,0,2,2,10,108,151,259,41.6988417,58.3011583,tract_part,http://www.prisonersofthecensus.org/data/2010blocks/121199105003006/
1.21E+14,851,4,7,0,116,10,278,1266,814,2080,60.86538462,39.13461538,tract,http://www.prisonersofthecensus.org/data/2010blocks/121199110001006/
1.21E+14,3427,80,31,5,306,215,1780,5844,1221,7065,82.71762208,17.28237792,tract_part,http://www.prisonersofthecensus.org/data/2010blocks/121199109001012/
1.21E+14,53,0,0,0,0,0,2,55,83,138,39.85507246,60.14492754,tract_part,http://www.prisonersofthecensus.org/data/2010blocks/121219704003015/
1.21E+14,404,0,1,0,5,1,62,473,398,871,54.3053961,45.6946039,tract,http://www.prisonersofthecensus.org/data/2010blocks/121219705002003/
1.21E+14,5,0,0,0,0,0,0,5,2,7,71.42857143,28.57142857,tract_part,http://www.prisonersofthecensus.org/data/2010blocks/121239502003038/
1.21E+14,35,0,0,0,0,0,2,37,42,79,46.83544304,53.16455696,tract_part,http://www.prisonersofthecensus.org/data/2010blocks/121239503001012/
1.21E+14,1336,5,7,0,75,20,363,1806,925,2731,66.12962285,33.87037715,institutionalized,http://www.prisonersofthecensus.org/data/2010blocks/121239504003150/
1.21E+14,182,1,0,0,10,1,30,224,219,443,50.56433409,49.43566591,institutionalized,http://www.prisonersofthecensus.org/data/2010blocks/121239504003151/
1.21E+14,2,0,0,0,0,0,0,2,17,19,10.52631579,89.47368421,tract_part,http://www.prisonersofthecensus.org/data/2010blocks/121259602003038/
1.21E+14,210,0,0,0,4,2,18,234,193,427,54.80093677,45.19906323,institutionalized,http://www.prisonersofthecensus.org/data/2010blocks/121259602005019/
1.21E+14,470,0,3,0,5,0,61,539,384,923,58.39653304,41.60346696,institutionalized,http://www.prisonersofthecensus.org/data/2010blocks/121259602005033/
1.21E+14,723,2,3,0,31,5,129,893,641,1534,58.21382008,41.78617992,institutionalized,http://www.prisonersofthecensus.org/data/2010blocks/121259602005039/
1.21E+14,798,3,1,0,0,5,140,947,974,1921,49.29724102,50.70275898,tract_part,http://www.prisonersofthecensus.org/data/2010blocks/121259601001045/
1.21E+14,459,0,0,0,0,0,38,497,846,1343,37.00670141,62.99329859,remaining,http://www.prisonersofthecensus.org/data/2010blocks/121270832061086/
1.21E+14,31,0,0,0,2,1,12,46,67,113,40.7079646,59.2920354,institutionalized,http://www.prisonersofthecensus.org/data/2010blocks/121270832061088/
1.21E+14,729,6,2,0,7,3,141,888,705,1593,55.74387947,44.25612053,institutionalized,http://www.prisonersofthecensus.org/data/2010blocks/121270832061092/
1.21E+14,39,0,0,0,0,0,6,45,41,86,52.3255814,47.6744186,tract_part,http://www.prisonersofthecensus.org/data/2010blocks/121270832073046/
1.21E+14,5,0,0,0,1,0,1,7,22,29,24.13793103,75.86206897,tract_part,http://www.prisonersofthecensus.org/data/2010blocks/121270826071001/
1.21E+14,37,0,1,0,0,0,15,53,71,124,42.74193548,57.25806452,tract_part,http://www.prisonersofthecensus.org/data/2010blocks/121290102033047/
1.21E+14,1740,5,3,1,28,8,272,2057,1276,3333,61.71617162,38.28382838,tract_part,http://www.prisonersofthecensus.org/data/2010blocks/121290102021019/
1.21E+14,708,3,5,2,11,5,114,848,933,1781,47.61370017,52.38629983,tract_part,http://www.prisonersofthecensus.org/data/2010blocks/121319502002006/
1.21E+14,56,0,1,0,0,5,5,67,88,155,43.22580645,56.77419355,tract_part,http://www.prisonersofthecensus.org/data/2010blocks/121339702002032/
1.21E+14,36,0,0,0,0,0,8,44,72,116,37.93103448,62.06896552,tract_part,http://www.prisonersofthecensus.org/data/2010blocks/121339701041063/
1.21E+14,1085,5,7,0,32,43,177,1349,1055,2404,56.11480865,43.88519135,tract_part,http://www.prisonersofthecensus.org/data/2010blocks/121339703023055/
1.30E+14,35,0,0,0,0,4,4,43,23,66,65.15151515,34.84848485,tract_part,http://www.prisonersofthecensus.org/data/2010blocks/130019502002054/
1.30E+14,163,0,0,0,4,0,4,171,40,211,81.04265403,18.95734597,tract_part,http://www.prisonersofthecensus.org/data/2010blocks/130019502002013/
1.30E+14,2,0,0,0,0,0,3,5,6,11,45.45454545,54.54545455,tract_part,http://www.prisonersofthecensus.org/data/2010blocks/130039602003056/
1.30E+14,24,0,0,0,1,0,1,26,23,49,53.06122449,46.93877551,tract_part,http://www.prisonersofthecensus.org/data/2010blocks/130059702013053/
1.30E+14,117,0,0,0,3,0,3,123,70,193,63.73056995,36.26943005,tract_part,http://www.prisonersofthecensus.org/data/2010blocks/130059702022004/
1.30E+14,555,0,0,0,0,5,21,581,304,885,65.64971751,34.35028249,tract_part,http://www.prisonersofthecensus.org/data/2010blocks/130099708001021/
1.30E+14,168,1,0,1,1,0,9,180,170,350,51.42857143,48.57142857,tract_part,http://www.prisonersofthecensus.org/data/2010blocks/130099707022045/
1.30E+14,325,0,0,0,5,0,12,342,330,672,50.89285714,49.10714286,tract_part,http://www.prisonersofthecensus.org/data/2010blocks/130099705003060/
1.30E+14,118,0,0,0,0,1,29,148,448,596,24.83221477,75.16778523,tract_part,http://www.prisonersofthecensus.org/data/2010blocks/130159604023060/
1.30E+14,73,0,0,0,0,0,7,80,30,110,72.72727273,27.27272727,tract_part,http://www.prisonersofthecensus.org/data/2010blocks/130179605003040/
1.30E+14,20,0,0,0,0,0,2,22,39,61,36.06557377,63.93442623,tract_part,http://www.prisonersofthecensus.org/data/2010blocks/130199703002027/
1.30E+14,432,1,2,0,5,1,13,454,443,897,50.61315496,49.38684504,tract_part,http://www.prisonersofthecensus.org/data/2010blocks/130210136032046/
1.30E+14,26,0,0,0,0,0,0,26,7,33,78.78787879,21.21212121,institutionalized,http://www.prisonersofthecensus.org/data/2010blocks/130210137001141/
1.30E+14,304,0,1,0,20,0,120,445,464,909,48.95489549,51.04510451,institutionalized,http://www.prisonersofthecensus.org/data/2010blocks/130210137001167/
1.30E+14,103,0,0,0,3,0,3,109,48,157,69.42675159,30.57324841,tract_part,http://www.prisonersofthecensus.org/data/2010blocks/130210139001104/
1.30E+14,25,0,0,0,0,0,2,27,24,51,52.94117647,47.05882353,institutionalized,http://www.prisonersofthecensus.org/data/2010blocks/130237902001076/
1.30E+14,33,0,0,0,0,0,0,33,89,122,27.04918033,72.95081967,institutionalized,http://www.prisonersofthecensus.org/data/2010blocks/130237902002000/
1.30E+14,348,0,1,0,15,1,17,382,139,521,73.32053743,26.67946257,tract_part,http://www.prisonersofthecensus.org/data/2010blocks/130311102006020/
1.30E+14,88,0,0,0,0,0,3,91,27,118,77.11864407,22.88135593,tract_part,http://www.prisonersofthecensus.org/data/2010blocks/130339505002050/
1.30E+14,47,0,0,0,0,0,6,53,46,99,53.53535354,46.46464646,institutionalized,http://www.prisonersofthecensus.org/data/2010blocks/130351502001037/
1.30E+14,1,0,0,0,0,0,0,1,1,2,50,50,institutionalized,http://www.prisonersofthecensus.org/data/2010blocks/130351502003023/
1.30E+14,1249,1,3,0,0,1,83,1337,671,2008,66.58366534,33.41633466,tract_part,http://www.prisonersofthecensus.org/data/2010blocks/130351503003039/
1.30E+14,3,0,0,0,0,0,0,3,1,4,75,25,remaining,http://www.prisonersofthecensus.org/data/2010blocks/130379501002051/
1.30E+14,17,0,0,0,0,0,0,17,3,20,85,15,institutionalized,http://www.prisonersofthecensus.org/data/2010blocks/130379501002077/
1.30E+14,1051,2,1,18,42,18,111,1243,447,1690,73.55029586,26.44970414,tract_part,http://www.prisonersofthecensus.org/data/2010blocks/130379501002050/
1.30E+14,6,0,0,0,0,0,0,6,13,19,31.57894737,68.42105263,tract_part,http://www.prisonersofthecensus.org/data/2010blocks/130390104012056/
1.30E+14,97,0,0,0,0,0,7,104,80,184,56.52173913,43.47826087,tract_part,http://www.prisonersofthecensus.org/data/2010blocks/130390102002022/
1.30E+14,20,0,0,0,1,0,3,24,14,38,63.15789474,36.84210526,tract_part,http://www.prisonersofthecensus.org/data/2010blocks/130439502001006/
1.30E+14,243,0,1,0,0,0,7,251,314,565,44.42477876,55.57522124,institutionalized,http://www.prisonersofthecensus.org/data/2010blocks/130459107011046/
1.30E+14,132,0,0,0,1,2,3,138,81,219,63.01369863,36.98630137,institutionalized,http://www.prisonersofthecensus.org/data/2010blocks/130459107012052/
1.30E+14,17,0,0,0,0,0,7,24,160,184,13.04347826,86.95652174,tract_part,http://www.prisonersofthecensus.org/data/2010blocks/130470302012042/
1.30E+14,1068,1,6,1,4,8,143,1231,434,1665,73.93393393,26.06606607,tract_part,http://www.prisonersofthecensus.org/data/2010blocks/130490101002406/
1.31E+14,1017,3,3,0,21,2,41,1087,571,1658,65.56091677,34.43908323,tract_part,http://www.prisonersofthecensus.org/data/2010blocks/130510107001278/
1.31E+14,192,0,0,0,0,0,0,192,66,258,74.41860465,25.58139535,tract,http://www.prisonersofthecensus.org/data/2010blocks/130510006014015/
1.31E+14,1146,10,4,0,39,43,102,1344,359,1703,78.91955373,21.08044627,tract_part,http://www.prisonersofthecensus.org/data/2010blocks/130510105013018/
1.31E+14,15,0,0,0,0,3,0,18,66,84,21.42857143,78.57142857,tract_part,http://www.prisonersofthecensus.org/data/2010blocks/130550104003009/
1.31E+14,1069,1,4,2,69,7,80,1232,503,1735,71.00864553,28.99135447,tract_part,http://www.prisonersofthecensus.org/data/2010blocks/130550105002002/
1.31E+14,92,4,2,1,18,11,83,211,374,585,36.06837607,63.93162393,tract_part,http://www.prisonersofthecensus.org/data/2010blocks/130570906012054/
1.31E+14,0,0,0,0,0,0,0,0,4,4,0,100,tract,http://www.prisonersofthecensus.org/data/2010blocks/130570908022008/
1.31E+14,294,0,1,0,7,2,13,317,121,438,72.37442922,27.62557078,tract,http://www.prisonersofthecensus.org/data/2010blocks/130591405001037/
1.31E+14,198,0,1,0,3,0,5,207,126,333,62.16216216,37.83783784,tract_part,http://www.prisonersofthecensus.org/data/2010blocks/130630403081078/
1.31E+14,1348,1,10,0,27,20,141,1547,290,1837,84.2133914,15.7866086,tract_part,http://www.prisonersofthecensus.org/data/2010blocks/130630406123040/
1.31E+14,124,0,1,0,0,0,7,132,84,216,61.11111111,38.88888889,institutionalized,http://www.prisonersofthecensus.org/data/2010blocks/130630406061032/
1.31E+14,252,3,5,0,133,2,228,623,112,735,84.76190476,15.23809524,remaining,http://www.prisonersofthecensus.org/data/2010blocks/130630406062002/
1.31E+14,21,0,0,0,0,0,0,21,8,29,72.4137931,27.5862069,tract_part,http://www.prisonersofthecensus.org/data/2010blocks/130659701004037/
1.31E+14,1,0,0,0,0,1,1,3,13,16,18.75,81.25,tract_part,http://www.prisonersofthecensus.org/data/2010blocks/130670301032014/
1.31E+14,1,1,0,0,1,0,2,5,7,12,41.66666667,58.33333333,tract_part,http://www.prisonersofthecensus.org/data/2010blocks/130670302152010/
1.31E+14,2,0,0,0,0,0,0,2,1,3,66.66666667,33.33333333,tract,http://www.prisonersofthecensus.org/data/2010blocks/130670314061011/
1.31E+14,136,0,0,0,0,0,8,144,114,258,55.81395349,44.18604651,remaining,http://www.prisonersofthecensus.org/data/2010blocks/130670309051008/
1.31E+14,1147,2,4,2,4,10,264,1433,662,2095,68.40095465,31.59904535,institutionalized,http://www.prisonersofthecensus.org/data/2010blocks/130670309051010/
1.31E+14,26,0,0,0,0,0,5,31,16,47,65.95744681,34.04255319,tract,http://www.prisonersofthecensus.org/data/2010blocks/130670311012015/
1.31E+14,128,0,0,0,11,0,16,155,121,276,56.15942029,43.84057971,tract_part,http://www.prisonersofthecensus.org/data/2010blocks/130690107003013/
1.31E+14,1211,1,3,0,9,7,59,1290,615,1905,67.71653543,32.28346457,tract_part,http://www.prisonersofthecensus.org/data/2010blocks/130690103002054/
1.31E+14,119,0,0,0,3,2,16,140,83,223,62.78026906,37.21973094,tract_part,http://www.prisonersofthecensus.org/data/2010blocks/130719704003004/
1.31E+14,140,1,0,0,0,0,0,141,48,189,74.6031746,25.3968254,tract_part,http://www.prisonersofthecensus.org/data/2010blocks/130719706001016/
1.31E+14,99,0,0,0,0,0,8,107,154,261,40.99616858,59.00383142,tract,http://www.prisonersofthecensus.org/data/2010blocks/130730304021013/
1.31E+14,189,1,1,0,21,3,29,244,158,402,60.69651741,39.30348259,tract_part,http://www.prisonersofthecensus.org/data/2010blocks/130771703052035/
1.31E+14,11,0,0,0,0,0,0,11,4,15,73.33333333,26.66666667,tract_part,http://www.prisonersofthecensus.org/data/2010blocks/130790701001085/
1.31E+14,149,0,0,0,0,1,10,160,46,206,77.66990291,22.33009709,tract_part,http://www.prisonersofthecensus.org/data/2010blocks/130810102012017/
1.31E+14,8,0,0,0,0,0,0,8,86,94,8.510638298,91.4893617,tract_part,http://www.prisonersofthecensus.org/data/2010blocks/130830401012121/
1.31E+14,8,0,0,0,0,0,1,9,128,137,6.569343066,93.43065693,tract_part,http://www.prisonersofthecensus.org/data/2010blocks/130859701002132/
1.31E+14,96,0,0,0,5,0,8,109,42,151,72.18543046,27.81456954,institutionalized,http://www.prisonersofthecensus.org/data/2010blocks/130879703002094/
1.31E+14,208,0,0,0,0,0,0,208,76,284,73.23943662,26.76056338,institutionalized,http://www.prisonersofthecensus.org/data/2010blocks/130879703002101/
1.31E+14,159,1,0,0,0,1,0,161,224,385,41.81818182,58.18181818,tract_part,http://www.prisonersofthecensus.org/data/2010blocks/130879703001009/
1.31E+14,2884,0,0,0,8,10,156,3058,297,3355,91.14754098,8.852459016,tract,http://www.prisonersofthecensus.org/data/2010blocks/130890231151008/
1.31E+14,3,0,0,0,0,0,0,3,0,3,100,0,tract_part,http://www.prisonersofthecensus.org/data/2010blocks/130890232043000/
1.31E+14,160,0,0,0,0,0,0,160,8,168,95.23809524,4.761904762,institutionalized,http://www.prisonersofthecensus.org/data/2010blocks/130890238022006/
1.31E+14,582,0,1,0,5,2,13,603,468,1071,56.30252101,43.69747899,institutionalized,http://www.prisonersofthecensus.org/data/2010blocks/130890238022022/
1.31E+14,805,0,3,1,0,3,46,858,377,1235,69.47368421,30.52631579,tract_part,http://www.prisonersofthecensus.org/data/2010blocks/130919601001025/
1.31E+14,22,0,0,0,0,1,15,38,38,76,50,50,tract_part,http://www.prisonersofthecensus.org/data/2010blocks/130919602002042/
1.31E+14,94,0,0,0,0,0,18,112,22,134,83.58208955,16.41791045,tract_part,http://www.prisonersofthecensus.org/data/2010blocks/130939701003051/
1.31E+14,1068,1,5,1,17,1,95,1188,603,1791,66.33165829,33.66834171,tract_part,http://www.prisonersofthecensus.org/data/2010blocks/130939701001010/
1.31E+14,697,1,0,0,0,0,1,699,130,829,84.31845597,15.68154403,tract,http://www.prisonersofthecensus.org/data/2010blocks/130950103023023/
1.31E+14,121,0,0,0,0,0,0,121,33,154,78.57142857,21.42857143,tract,http://www.prisonersofthecensus.org/data/2010blocks/130950114002004/
1.31E+14,0,0,0,0,0,0,0,0,5,5,0,100,institutionalized,http://www.prisonersofthecensus.org/data/2010blocks/130970803041003/
1.31E+14,451,0,0,0,0,0,21,472,330,802,58.85286783,41.14713217,institutionalized,http://www.prisonersofthecensus.org/data/2010blocks/130970803042024/
1.31E+14,42,0,0,0,0,0,0,42,5,47,89.36170213,10.63829787,tract_part,http://www.prisonersofthecensus.org/data/2010blocks/130990904003012/
1.31E+14,355,0,0,0,7,1,8,371,131,502,73.90438247,26.09561753,tract_part,http://www.prisonersofthecensus.org/data/2010blocks/131030302031003/
1.31E+14,23,0,0,0,0,1,2,26,24,50,52,48,tract_part,http://www.prisonersofthecensus.org/data/2010blocks/131050004003005/
1.31E+14,155,0,0,0,3,0,3,161,59,220,73.18181818,26.81818182,institutionalized,http://www.prisonersofthecensus.org/data/2010blocks/131079704001091/
1.31E+14,68,0,0,0,0,0,2,70,48,118,59.3220339,40.6779661,institutionalized,http://www.prisonersofthecensus.org/data/2010blocks/131079704001097/
1.31E+14,155,0,0,0,1,0,1,157,111,268,58.58208955,41.41791045,tract_part,http://www.prisonersofthecensus.org/data/2010blocks/131079701003054/
1.31E+14,193,0,0,0,4,2,4,203,154,357,56.8627451,43.1372549,institutionalized,http://www.prisonersofthecensus.org/data/2010blocks/131099703001022/
1.31E+14,13,0,0,0,0,0,0,13,5,18,72.22222222,27.77777778,institutionalized,http://www.prisonersofthecensus.org/data/2010blocks/131099703001045/
1.31E+14,0,0,0,0,0,0,0,0,55,55,0,100,tract_part,http://www.prisonersofthecensus.org/data/2010blocks/131110504004055/
1.31E+14,158,1,3,2,2,1,10,177,112,289,61.24567474,38.75432526,tract_part,http://www.prisonersofthecensus.org/data/2010blocks/131131404073010/
1.31E+14,262,0,1,0,0,0,17,280,387,667,41.97901049,58.02098951,tract_part,http://www.prisonersofthecensus.org/data/2010blocks/131150006002084/
1.31E+14,216,0,0,0,0,0,11,227,133,360,63.05555556,36.94444444,tract_part,http://www.prisonersofthecensus.org/data/2010blocks/131150021002025/
1.31E+14,0,1,0,0,0,0,1,2,3,5,40,60,institutionalized,http://www.prisonersofthecensus.org/data/2010blocks/131171304101002/
1.31E+14,23,3,1,0,6,2,36,71,175,246,28.86178862,71.13821138,institutionalized,http://www.prisonersofthecensus.org/data/2010blocks/131171304102017/
1.31E+14,16,0,0,0,1,0,2,19,47,66,28.78787879,71.21212121,tract_part,http://www.prisonersofthecensus.org/data/2010blocks/131198902003029/
1.31E+14,1682,0,3,0,23,22,68,1798,133,1931,93.11237701,6.887622993,tract,http://www.prisonersofthecensus.org/data/2010blocks/131210007001000/
1.31E+14,19,0,0,0,2,2,2,25,1,26,96.15384615,3.846153846,tract,http://www.prisonersofthecensus.org/data/2010blocks/131210012012004/
1.31E+14,159,0,0,0,0,0,2,161,92,253,63.63636364,36.36363636,tract,http://www.prisonersofthecensus.org/data/2010blocks/131210013003007/
1.31E+14,306,2,12,1,16,6,86,429,45,474,90.50632911,9.493670886,tract,http://www.prisonersofthecensus.org/data/2010blocks/131210035002034/
1.31E+14,4,0,0,0,0,0,0,4,0,4,100,0,tract,http://www.prisonersofthecensus.org/data/2010blocks/131210067003022/
1.31E+14,1277,10,12,0,33,1,556,1889,766,2655,71.14877589,28.85122411,tract,http://www.prisonersofthecensus.org/data/2010blocks/131210068011000/
1.31E+14,93,1,2,0,0,3,5,104,39,143,72.72727273,27.27272727,tract_part,http://www.prisonersofthecensus.org/data/2010blocks/131210078051003/
1.31E+14,9,0,0,0,0,2,0,11,1,12,91.66666667,8.333333333,tract,http://www.prisonersofthecensus.org/data/2010blocks/131210112023012/
1.31E+14,2,0,0,0,0,1,0,3,4,7,42.85714286,57.14285714,tract_part,http://www.prisonersofthecensus.org/data/2010blocks/131210105151033/
1.31E+14,35,0,0,0,0,1,2,38,1,39,97.43589744,2.564102564,tract,http://www.prisonersofthecensus.org/data/2010blocks/131210116162019/
1.31E+14,13,0,0,0,0,0,26,39,12,51,76.47058824,23.52941176,tract,http://www.prisonersofthecensus.org/data/2010blocks/131210114051021/
1.31E+14,7,0,0,0,0,0,8,15,98,113,13.27433628,86.72566372,tract_part,http://www.prisonersofthecensus.org/data/2010blocks/131230805002002/
1.31E+14,235,0,0,0,2,0,22,259,191,450,57.55555556,42.44444444,tract,http://www.prisonersofthecensus.org/data/2010blocks/131270008001031/
1.31E+14,66,2,0,1,17,2,19,107,189,296,36.14864865,63.85135135,tract_part,http://www.prisonersofthecensus.org/data/2010blocks/131299703003007/
1.31E+14,54,0,0,0,2,0,10,66,49,115,57.39130435,42.60869565,tract_part,http://www.prisonersofthecensus.org/data/2010blocks/131319504003008/
1.31E+14,50,0,0,0,0,0,1,51,10,61,83.60655738,16.39344262,tract_part,http://www.prisonersofthecensus.org/data/2010blocks/131339503032038/
1.31E+14,433,2,3,0,3,1,6,448,381,829,54.04101327,45.95898673,tract_part,http://www.prisonersofthecensus.org/data/2010blocks/131350506091013/
1.31E+14,1193,30,66,6,381,128,919,2723,846,3569,76.2958812,23.7041188,tract_part,http://www.prisonersofthecensus.org/data/2010blocks/131350505481026/
1.31E+14,10,0,1,0,0,0,7,18,96,114,15.78947368,84.21052632,tract_part,http://www.prisonersofthecensus.org/data/2010blocks/131370003003056/
1.31E+14,605,3,2,0,1,7,43,661,888,1549,42.67269206,57.32730794,tract_part,http://www.prisonersofthecensus.org/data/2010blocks/131370006012032/
1.31E+14,30,1,0,0,3,1,13,48,103,151,31.78807947,68.21192053,tract_part,http://www.prisonersofthecensus.org/data/2010blocks/131390006003071/
1.31E+14,444,1,10,0,23,5,174,657,494,1151,57.0807993,42.9192007,tract_part,http://www.prisonersofthecensus.org/data/2010blocks/131390012013050/
1.31E+14,26,0,0,0,0,1,0,27,1,28,96.42857143,3.571428571,tract_part,http://www.prisonersofthecensus.org/data/2010blocks/131414804005002/
1.31E+14,946,8,3,0,5,5,86,1053,299,1352,77.88461538,22.11538462,tract_part,http://www.prisonersofthecensus.org/data/2010blocks/131414804001044/
1.31E+14,15,0,0,0,0,0,1,16,83,99,16.16161616,83.83838384,tract_part,http://www.prisonersofthecensus.org/data/2010blocks/131430103022013/
1.31E+14,36,0,2,0,0,2,4,44,49,93,47.31182796,52.68817204,tract_part,http://www.prisonersofthecensus.org/data/2010blocks/131451203001061/
1.31E+14,73,0,0,0,1,0,2,76,31,107,71.02803738,28.97196262,tract_part,http://www.prisonersofthecensus.org/data/2010blocks/131451202002053/
1.31E+14,17,0,1,0,2,0,2,22,21,43,51.1627907,48.8372093,tract_part,http://www.prisonersofthecensus.org/data/2010blocks/131479604004066/
1.31E+14,269,0,0,0,0,0,1,270,150,420,64.28571429,35.71428571,tract_part,http://www.prisonersofthecensus.org/data/2010blocks/131479605004118/
1.32E+14,23,0,2,0,6,1,7,39,24,63,61.9047619,38.0952381,tract_part,http://www.prisonersofthecensus.org/data/2010blocks/131499701002038/
1.32E+14,347,0,3,0,0,0,22,372,304,676,55.0295858,44.9704142,tract_part,http://www.prisonersofthecensus.org/data/2010blocks/131510703042059/
1.32E+14,55,0,2,0,2,2,15,76,90,166,45.78313253,54.21686747,institutionalized,http://www.prisonersofthecensus.org/data/2010blocks/131530214004124/
1.32E+14,263,1,0,0,5,11,17,297,187,484,61.36363636,38.63636364,institutionalized,http://www.prisonersofthecensus.org/data/2010blocks/131530214004141/
1.32E+14,6,0,0,0,0,0,0,6,9,15,40,60,tract_part,http://www.prisonersofthecensus.org/data/2010blocks/131530211045000/
1.32E+14,299,0,0,0,1,0,21,321,219,540,59.44444444,40.55555556,tract_part,http://www.prisonersofthecensus.org/data/2010blocks/131559502005026/
1.32E+14,88,0,0,0,0,0,3,91,77,168,54.16666667,45.83333333,institutionalized,http://www.prisonersofthecensus.org/data/2010blocks/131570107012024/
1.32E+14,54,0,0,0,3,1,10,68,112,180,37.77777778,62.22222222,institutionalized,http://www.prisonersofthecensus.org/data/2010blocks/131570107012025/
1.32E+14,19,0,0,0,0,0,1,20,20,40,50,50,tract_part,http://www.prisonersofthecensus.org/data/2010blocks/131590105004053/
1.32E+14,12,0,0,0,0,0,0,12,32,44,27.27272727,72.72727273,tract_part,http://www.prisonersofthecensus.org/data/2010blocks/131619602004046/
1.32E+14,69,0,0,0,1,0,3,73,12,85,85.88235294,14.11764706,tract_part,http://www.prisonersofthecensus.org/data/2010blocks/131639603002004/
1.32E+14,125,0,0,0,0,0,2,127,52,179,70.94972067,29.05027933,tract_part,http://www.prisonersofthecensus.org/data/2010blocks/131639603002003/
1.32E+14,20,2,0,0,0,3,1,26,12,38,68.42105263,31.57894737,tract_part,http://www.prisonersofthecensus.org/data/2010blocks/131679602001049/
1.32E+14,784,0,5,0,0,0,47,836,735,1571,53.21451305,46.78548695,tract_part,http://www.prisonersofthecensus.org/data/2010blocks/131679602001024/
1.32E+14,72,0,0,0,0,2,6,80,81,161,49.68944099,50.31055901,tract_part,http://www.prisonersofthecensus.org/data/2010blocks/131690303011023/
1.32E+14,99,0,1,0,1,0,8,109,95,204,53.43137255,46.56862745,tract_part,http://www.prisonersofthecensus.org/data/2010blocks/131719702001075/
1.32E+14,42,0,0,0,0,0,0,42,51,93,45.16129032,54.83870968,tract_part,http://www.prisonersofthecensus.org/data/2010blocks/131719703002039/
1.32E+14,114,1,0,0,0,0,9,124,89,213,58.21596244,41.78403756,tract_part,http://www.prisonersofthecensus.org/data/2010blocks/131739502002019/
1.32E+14,125,0,0,0,0,0,1,126,59,185,68.10810811,31.89189189,tract_part,http://www.prisonersofthecensus.org/data/2010blocks/131759514002033/
1.32E+14,115,0,1,0,2,1,3,122,77,199,61.30653266,38.69346734,tract_part,http://www.prisonersofthecensus.org/data/2010blocks/131759508003146/
1.32E+14,26,0,0,0,0,0,1,27,36,63,42.85714286,57.14285714,institutionalized,http://www.prisonersofthecensus.org/data/2010blocks/131770203003005/
1.32E+14,431,0,1,0,1,2,23,458,182,640,71.5625,28.4375,institutionalized,http://www.prisonersofthecensus.org/data/2010blocks/131770203003010/
1.32E+14,185,0,0,0,14,0,14,213,51,264,80.68181818,19.31818182,tract_part,http://www.prisonersofthecensus.org/data/2010blocks/131790102081021/
1.32E+14,39,0,1,0,0,0,0,40,18,58,68.96551724,31.03448276,tract_part,http://www.prisonersofthecensus.org/data/2010blocks/131819701004029/
1.32E+14,124,0,0,0,9,1,8,142,93,235,60.42553191,39.57446809,tract_part,http://www.prisonersofthecensus.org/data/2010blocks/131839702003068/
1.32E+14,18,0,3,0,2,4,12,39,39,78,50,50,tract_part,http://www.prisonersofthecensus.org/data/2010blocks/131850101024052/
1.32E+14,978,0,1,0,2,2,34,1017,445,1462,69.5622435,30.4377565,tract_part,http://www.prisonersofthecensus.org/data/2010blocks/131850102012039/
1.32E+14,437,0,0,0,3,2,17,459,185,644,71.27329193,28.72670807,tract_part,http://www.prisonersofthecensus.org/data/2010blocks/131850114022056/
1.32E+14,81,0,0,0,0,0,1,82,20,102,80.39215686,19.60784314,tract_part,http://www.prisonersofthecensus.org/data/2010blocks/131850114022068/
1.32E+14,5,0,0,0,1,13,8,27,94,121,22.31404959,77.68595041,tract_part,http://www.prisonersofthecensus.org/data/2010blocks/131879602023002/
1.32E+14,52,0,0,0,0,0,1,53,81,134,39.55223881,60.44776119,tract_part,http://www.prisonersofthecensus.org/data/2010blocks/131899504001041/
1.32E+14,100,0,0,0,2,1,3,106,44,150,70.66666667,29.33333333,tract_part,http://www.prisonersofthecensus.org/data/2010blocks/131899504004013/
1.32E+14,41,1,0,0,0,0,2,44,27,71,61.97183099,38.02816901,tract_part,http://www.prisonersofthecensus.org/data/2010blocks/131911103001043/
1.32E+14,29,0,0,0,0,0,0,29,3,32,90.625,9.375,tract_part,http://www.prisonersofthecensus.org/data/2010blocks/131930003002067/
1.32E+14,1334,0,11,1,1,3,83,1433,313,1746,82.07331042,17.92668958,tract_part,http://www.prisonersofthecensus.org/data/2010blocks/131930003001097/
1.32E+14,15,0,0,0,0,0,1,16,30,46,34.7826087,65.2173913,tract_part,http://www.prisonersofthecensus.org/data/2010blocks/131950202001077/
1.32E+14,13,0,0,0,0,0,0,13,13,26,50,50,tract_part,http://www.prisonersofthecensus.org/data/2010blocks/131979202003014/
1.32E+14,42,0,0,0,0,0,0,42,17,59,71.18644068,28.81355932,tract_part,http://www.prisonersofthecensus.org/data/2010blocks/132019502001037/
1.32E+14,0,0,0,0,0,0,0,0,23,23,0,100,tract_part,http://www.prisonersofthecensus.org/data/2010blocks/132050903003017/
1.32E+14,102,0,0,0,0,0,0,102,34,136,75,25,tract_part,http://www.prisonersofthecensus.org/data/2010blocks/132050904002015/
1.32E+14,62,0,0,0,1,0,1,64,17,81,79.01234568,20.98765432,institutionalized,http://www.prisonersofthecensus.org/data/2010blocks/132050904002019/
1.32E+14,1066,0,4,0,3,3,116,1192,465,1657,71.93723597,28.06276403,institutionalized,http://www.prisonersofthecensus.org/data/2010blocks/132050904002051/
1.32E+14,43,0,0,0,0,0,0,43,3,46,93.47826087,6.52173913,tract_part,http://www.prisonersofthecensus.org/data/2010blocks/132050902001058/
1.32E+14,9,0,0,0,0,0,7,16,4,20,80,20,tract_part,http://www.prisonersofthecensus.org/data/2010blocks/132050905003016/
1.32E+14,78,1,0,0,3,0,5,87,117,204,42.64705882,57.35294118,institutionalized,http://www.prisonersofthecensus.org/data/2010blocks/132070502002000/
1.32E+14,61,1,0,0,1,0,3,66,79,145,45.51724138,54.48275862,institutionalized,http://www.prisonersofthecensus.org/data/2010blocks/132070502002001/
1.32E+14,381,0,3,0,4,3,33,424,166,590,71.86440678,28.13559322,institutionalized,http://www.prisonersofthecensus.org/data/2010blocks/132070502002013/
1.32E+14,253,1,0,0,1,0,26,281,128,409,68.70415648,31.29584352,tract_part,http://www.prisonersofthecensus.org/data/2010blocks/132099502003011/
1.32E+14,22,1,0,0,1,0,2,26,45,71,36.61971831,63.38028169,tract_part,http://www.prisonersofthecensus.org/data/2010blocks/132110103003039/
1.32E+14,4,2,0,0,4,0,6,16,123,139,11.51079137,88.48920863,tract_part,http://www.prisonersofthecensus.org/data/2010blocks/132130104001007/
1.32E+14,3,0,0,0,0,0,0,3,2,5,60,40,tract,http://www.prisonersofthecensus.org/data/2010blocks/132150106052004/
1.32E+14,899,1,3,0,7,1,37,948,416,1364,69.50146628,30.49853372,tract,http://www.prisonersofthecensus.org/data/2010blocks/132150106061003/
1.32E+14,659,0,0,0,0,0,16,675,282,957,70.53291536,29.46708464,tract,http://www.prisonersofthecensus.org/data/2010blocks/132150025001004/
1.32E+14,354,2,0,0,2,2,10,370,257,627,59.01116427,40.98883573,tract_part,http://www.prisonersofthecensus.org/data/2010blocks/132171001004078/
1.32E+14,9,0,1,0,0,0,0,10,22,32,31.25,68.75,tract_part,http://www.prisonersofthecensus.org/data/2010blocks/132171004002066/
1.32E+14,0,0,0,0,0,0,1,1,2,3,33.33333333,66.66666667,tract_part,http://www.prisonersofthecensus.org/data/2010blocks/132171002013023/
1.32E+14,12,0,0,0,0,0,5,17,15,32,53.125,46.875,tract_part,http://www.prisonersofthecensus.org/data/2010blocks/132190304003044/
1.32E+14,40,0,0,0,0,1,0,41,16,57,71.92982456,28.07017544,tract_part,http://www.prisonersofthecensus.org/data/2010blocks/132219602023074/
1.32E+14,70,0,1,0,0,0,1,72,65,137,52.55474453,47.44525547,institutionalized,http://www.prisonersofthecensus.org/data/2010blocks/132231201021032/
1.32E+14,59,0,0,0,0,2,12,73,162,235,31.06382979,68.93617021,remaining,http://www.prisonersofthecensus.org/data/2010blocks/132231201021038/
1.32E+14,3,0,0,0,0,0,3,6,98,104,5.769230769,94.23076923,tract_part,http://www.prisonersofthecensus.org/data/2010blocks/132270502004050/
1.32E+14,22,0,0,0,0,0,4,26,23,49,53.06122449,46.93877551,tract_part,http://www.prisonersofthecensus.org/data/2010blocks/132299604002041/
1.32E+14,12,0,0,0,0,1,0,13,13,26,50,50,tract_part,http://www.prisonersofthecensus.org/data/2010blocks/132310101001063/
1.32E+14,90,0,0,0,0,0,0,90,96,186,48.38709677,51.61290323,tract_part,http://www.prisonersofthecensus.org/data/2010blocks/132310101003002/
1.32E+14,44,0,0,0,0,0,2,46,81,127,36.22047244,63.77952756,tract_part,http://www.prisonersofthecensus.org/data/2010blocks/132330103003022/
1.32E+14,548,2,4,0,0,1,23,578,572,1150,50.26086957,49.73913043,tract_part,http://www.prisonersofthecensus.org/data/2010blocks/132359501001018/
1.32E+14,52,0,0,0,0,0,5,57,30,87,65.51724138,34.48275862,tract_part,http://www.prisonersofthecensus.org/data/2010blocks/132379602022022/
1.32E+14,3,0,0,0,1,0,3,7,61,68,10.29411765,89.70588235,tract_part,http://www.prisonersofthecensus.org/data/2010blocks/132419703021026/
1.32E+14,34,0,0,0,0,0,0,34,0,34,100,0,tract_part,http://www.prisonersofthecensus.org/data/2010blocks/132437902004081/
1.32E+14,148,0,0,0,0,0,0,148,54,202,73.26732673,26.73267327,institutionalized,http://www.prisonersofthecensus.org/data/2010blocks/132450006002030/
1.32E+14,260,1,0,0,1,4,4,270,110,380,71.05263158,28.94736842,institutionalized,http://www.prisonersofthecensus.org/data/2010blocks/132450006003017/
1.32E+14,661,0,2,0,1,3,12,679,422,1101,61.67120799,38.32879201,tract,http://www.prisonersofthecensus.org/data/2010blocks/132450102044061/
1.32E+14,355,2,0,0,5,4,5,371,150,521,71.20921305,28.79078695,tract,http://www.prisonersofthecensus.org/data/2010blocks/132450105111022/
1.32E+14,153,0,0,0,0,0,1,154,55,209,73.68421053,26.31578947,tract,http://www.prisonersofthecensus.org/data/2010blocks/132450107101000/
1.32E+14,0,0,0,0,0,0,0,0,1,1,0,100,tract_part,http://www.prisonersofthecensus.org/data/2010blocks/132450109031102/
1.32E+14,294,0,2,0,15,0,30,341,172,513,66.47173489,33.52826511,tract_part,http://www.prisonersofthecensus.org/data/2010blocks/132470602012010/
1.33E+14,113,0,0,0,0,1,4,118,26,144,81.94444444,18.05555556,tract_part,http://www.prisonersofthecensus.org/data/2010blocks/132519703001073/
1.33E+14,10,0,0,0,0,0,0,10,18,28,35.71428571,64.28571429,tract_part,http://www.prisonersofthecensus.org/data/2010blocks/132532002003032/
1.33E+14,226,0,1,0,0,4,21,252,134,386,65.28497409,34.71502591,tract_part,http://www.prisonersofthecensus.org/data/2010blocks/132551607003010/
1.33E+14,82,0,7,0,164,0,192,445,97,542,82.10332103,17.89667897,tract_part,http://www.prisonersofthecensus.org/data/2010blocks/132551607003014/
1.33E+14,0,0,0,0,0,0,0,0,2,2,0,100,tract_part,http://www.prisonersofthecensus.org/data/2010blocks/132579701002028/
1.33E+14,88,2,28,0,1361,2,1395,2876,92,2968,96.90026954,3.099730458,tract_part,http://www.prisonersofthecensus.org/data/2010blocks/132599504002008/
1.33E+14,414,0,0,0,0,1,12,427,116,543,78.63720074,21.36279926,tract_part,http://www.prisonersofthecensus.org/data/2010blocks/132619503005019/
1.33E+14,14,0,0,0,0,0,0,14,3,17,82.35294118,17.64705882,tract_part,http://www.prisonersofthecensus.org/data/2010blocks/132639602002047/
1.33E+14,1148,2,6,0,15,3,84,1258,367,1625,77.41538462,22.58461538,tract_part,http://www.prisonersofthecensus.org/data/2010blocks/132679503001272/
1.33E+14,897,1,2,0,1,0,80,981,498,1479,66.32860041,33.67139959,tract_part,http://www.prisonersofthecensus.org/data/2010blocks/132679502012059/
1.33E+14,564,1,2,1,4,1,30,603,273,876,68.83561644,31.16438356,tract_part,http://www.prisonersofthecensus.org/data/2010blocks/132679502022097/
1.33E+14,436,0,2,0,2,0,25,465,208,673,69.0936107,30.9063893,tract_part,http://www.prisonersofthecensus.org/data/2010blocks/132679502021031/
1.33E+14,16,0,0,0,0,0,0,16,4,20,80,20,tract_part,http://www.prisonersofthecensus.org/data/2010blocks/132699503003006/
1.33E+14,157,0,0,0,0,0,7,164,47,211,77.72511848,22.27488152,tract,http://www.prisonersofthecensus.org/data/2010blocks/132699501001019/
1.33E+14,842,0,1,0,0,3,62,908,239,1147,79.163034,20.836966,tract_part,http://www.prisonersofthecensus.org/data/2010blocks/132719501002025/
1.33E+14,17,0,0,0,0,0,2,19,8,27,70.37037037,29.62962963,institutionalized,http://www.prisonersofthecensus.org/data/2010blocks/132719501004008/
1.33E+14,344,18,46,0,300,169,1429,2306,86,2392,96.40468227,3.595317726,institutionalized,http://www.prisonersofthecensus.org/data/2010blocks/132719501005088/
1.33E+14,140,0,0,0,0,0,2,142,44,186,76.34408602,23.65591398,tract_part,http://www.prisonersofthecensus.org/data/2010blocks/132731204001063/
1.33E+14,147,0,0,0,0,0,1,148,33,181,81.7679558,18.2320442,tract_part,http://www.prisonersofthecensus.org/data/2010blocks/132759610003002/
1.33E+14,126,0,0,0,1,1,5,133,72,205,64.87804878,35.12195122,tract_part,http://www.prisonersofthecensus.org/data/2010blocks/132779607001003/
1.33E+14,1,0,0,0,0,0,2,3,35,38,7.894736842,92.10526316,tract_part,http://www.prisonersofthecensus.org/data/2010blocks/132819601001021/
1.33E+14,14,0,0,0,0,0,4,18,8,26,69.23076923,30.76923077,institutionalized,http://www.prisonersofthecensus.org/data/2010blocks/132839602004039/
1.33E+14,177,0,2,0,2,0,3,184,96,280,65.71428571,34.28571429,institutionalized,http://www.prisonersofthecensus.org/data/2010blocks/132839602005050/
1.33E+14,98,0,0,0,2,0,3,103,53,156,66.02564103,33.97435897,tract_part,http://www.prisonersofthecensus.org/data/2010blocks/132859606001035/
1.33E+14,485,0,2,0,0,1,17,505,292,797,63.36260979,36.63739021,tract_part,http://www.prisonersofthecensus.org/data/2010blocks/132859607004019/
1.33E+14,153,0,0,0,3,0,5,161,54,215,74.88372093,25.11627907,tract_part,http://www.prisonersofthecensus.org/data/2010blocks/132879703001016/
1.33E+14,30,0,0,0,1,0,1,32,6,38,84.21052632,15.78947368,tract_part,http://www.prisonersofthecensus.org/data/2010blocks/132879703001003/
1.33E+14,29,1,1,0,0,1,1,33,140,173,19.07514451,80.92485549,tract_part,http://www.prisonersofthecensus.org/data/2010blocks/132910002052022/
1.33E+14,0,0,0,0,0,1,1,2,55,57,3.50877193,96.49122807,tract_part,http://www.prisonersofthecensus.org/data/2010blocks/132910002052077/
1.33E+14,91,0,0,0,0,0,0,91,103,194,46.90721649,53.09278351,tract_part,http://www.prisonersofthecensus.org/data/2010blocks/132930102013016/
1.33E+14,30,0,0,0,0,0,4,34,171,205,16.58536585,83.41463415,tract_part,http://www.prisonersofthecensus.org/data/2010blocks/132950207003024/
1.33E+14,268,0,1,0,0,0,34,303,319,622,48.71382637,51.28617363,tract,http://www.prisonersofthecensus.org/data/2010blocks/132950206012016/
1.33E+14,186,0,3,0,5,1,10,205,248,453,45.25386313,54.74613687,tract_part,http://www.prisonersofthecensus.org/data/2010blocks/132971107004009/
1.33E+14,193,0,0,0,9,0,10,212,165,377,56.23342175,43.76657825,institutionalized,http://www.prisonersofthecensus.org/data/2010blocks/132999502002030/
1.33E+14,18,0,0,0,0,0,2,20,9,29,68.96551724,31.03448276,institutionalized,http://www.prisonersofthecensus.org/data/2010blocks/132999502002034/
1.33E+14,1066,1,5,1,21,7,54,1155,401,1556,74.22879177,25.77120823,institutionalized,http://www.prisonersofthecensus.org/data/2010blocks/132999502002038/
1.33E+14,952,0,9,0,10,3,128,1102,467,1569,70.23581899,29.76418101,tract_part,http://www.prisonersofthecensus.org/data/2010blocks/133039505001057/
1.33E+14,45,0,1,0,0,0,1,47,22,69,68.11594203,31.88405797,tract_part,http://www.prisonersofthecensus.org/data/2010blocks/133039503002063/
1.33E+14,64,0,0,0,1,0,2,67,58,125,53.6,46.4,tract_part,http://www.prisonersofthecensus.org/data/2010blocks/133059703004025/
1.33E+14,1008,36,9,1,75,61,433,1623,474,2097,77.3962804,22.6037196,tract_part,http://www.prisonersofthecensus.org/data/2010blocks/133059705001037/
1.33E+14,1209,0,3,0,0,4,90,1306,631,1937,67.42385132,32.57614868,tract_part,http://www.prisonersofthecensus.org/data/2010blocks/133097802003065/
1.33E+14,3,0,0,0,0,0,1,4,58,62,6.451612903,93.5483871,tract_part,http://www.prisonersofthecensus.org/data/2010blocks/133119502032106/
1.33E+14,57,0,1,0,2,1,61,122,255,377,32.36074271,67.63925729,tract_part,http://www.prisonersofthecensus.org/data/2010blocks/133130005024018/
1.33E+14,15,0,0,0,0,0,0,15,3,18,83.33333333,16.66666667,institutionalized,http://www.prisonersofthecensus.org/data/2010blocks/133159601001100/
1.33E+14,1162,3,10,0,15,40,120,1350,516,1866,72.34726688,27.65273312,institutionalized,http://www.prisonersofthecensus.org/data/2010blocks/133159601001122/
1.33E+14,41,0,0,0,0,0,0,41,10,51,80.39215686,19.60784314,tract_part,http://www.prisonersofthecensus.org/data/2010blocks/133170103024022/
1.33E+14,136,1,0,0,0,0,9,146,69,215,67.90697674,32.09302326,tract_part,http://www.prisonersofthecensus.org/data/2010blocks/133170103023043/
1.33E+14,21,0,1,0,0,0,1,23,16,39,58.97435897,41.02564103,tract_part,http://www.prisonersofthecensus.org/data/2010blocks/133199602003005/
1.33E+14,9,0,0,0,0,0,0,9,17,26,34.61538462,65.38461538,tract_part,http://www.prisonersofthecensus.org/data/2010blocks/133219505003040/
1.50E+14,2,0,1,0,0,0,0,3,2,5,60,40,tract,http://www.prisonersofthecensus.org/data/2010blocks/150010203002012/
1.50E+14,8,0,47,93,16,1,15,180,91,271,66.42066421,33.57933579,institutionalized,http://www.prisonersofthecensus.org/data/2010blocks/150010202021103/
1.50E+14,11,2,69,193,29,3,36,343,153,496,69.15322581,30.84677419,institutionalized,http://www.prisonersofthecensus.org/data/2010blocks/150010202021242/
1.50E+14,NULL,NULL,NULL,NULL,NULL,NULL,NULL,#VALUE!,NULL,#VALUE!,#VALUE!,#VALUE!,,http://www.prisonersofthecensus.org/data/2010blocks/150030087021003/
1.50E+14,NULL,NULL,NULL,NULL,NULL,NULL,NULL,#VALUE!,NULL,#VALUE!,#VALUE!,#VALUE!,,http://www.prisonersofthecensus.org/data/2010blocks/150030087021004/
1.50E+14,2,0,0,0,1,2,3,8,20,28,28.57142857,71.42857143,tract_part,http://www.prisonersofthecensus.org/data/2010blocks/150030074001050/
1.50E+14,48,3,222,405,20,21,46,765,198,963,79.43925234,20.56074766,tract_part,http://www.prisonersofthecensus.org/data/2010blocks/150030075021018/
1.50E+14,10,3,75,122,8,1,31,250,53,303,82.50825083,17.49174917,tract_part,http://www.prisonersofthecensus.org/data/2010blocks/150030089312002/
1.50E+14,9,0,11,10,1,12,5,48,28,76,63.15789474,36.84210526,tract,http://www.prisonersofthecensus.org/data/2010blocks/150030037005000/
1.50E+14,4,0,24,22,0,30,16,96,19,115,83.47826087,16.52173913,tract,http://www.prisonersofthecensus.org/data/2010blocks/150030057001011/
1.50E+14,79,2,345,673,40,10,106,1255,282,1537,81.65256994,18.34743006,tract,http://www.prisonersofthecensus.org/data/2010blocks/150030059001006/
1.50E+14,24,6,155,148,20,246,125,724,81,805,89.9378882,10.0621118,tract,http://www.prisonersofthecensus.org/data/2010blocks/150039802001004/
1.50E+14,0,0,0,0,0,0,0,0,12,12,0,100,tract,http://www.prisonersofthecensus.org/data/2010blocks/150030109042003/
1.50E+14,11,2,68,148,6,0,24,259,68,327,79.20489297,20.79510703,tract_part,http://www.prisonersofthecensus.org/data/2010blocks/150030110003001/
1.50E+14,0,0,0,0,0,1,0,1,0,1,100,0,tract_part,http://www.prisonersofthecensus.org/data/2010blocks/150070401031086/
1.50E+14,1,0,76,122,5,1,11,216,78,294,73.46938776,26.53061224,tract_part,http://www.prisonersofthecensus.org/data/2010blocks/150070404001323/
1.50E+14,12,8,104,251,30,130,83,618,190,808,76.48514851,23.51485149,tract,http://www.prisonersofthecensus.org/data/2010blocks/150090311014003/
1.60E+14,8,6,0,0,3,4,30,51,153,204,25,75,tract_part,http://www.prisonersofthecensus.org/data/2010blocks/160010007021039/
1.60E+14,46,7,2,1,39,9,104,208,769,977,21.28966223,78.71033777,tract,http://www.prisonersofthecensus.org/data/2010blocks/160010020002031/
1.60E+14,0,0,0,0,0,1,5,6,22,28,21.42857143,78.57142857,tract_part,http://www.prisonersofthecensus.org/data/2010blocks/160010024102016/
1.60E+14,1,1,0,0,2,4,5,13,61,74,17.56756757,82.43243243,tract_part,http://www.prisonersofthecensus.org/data/2010blocks/160010024122002/
1.60E+14,4,3,0,0,1,1,3,12,90,102,11.76470588,88.23529412,institutionalized,http://www.prisonersofthecensus.org/data/2010blocks/160010105011045/
1.60E+14,21,30,1,0,38,18,104,212,761,973,21.78828366,78.21171634,institutionalized,http://www.prisonersofthecensus.org/data/2010blocks/160010105011049/
1.60E+14,84,42,7,3,100,53,291,580,1666,2246,25.82368655,74.17631345,institutionalized,http://www.prisonersofthecensus.org/data/2010blocks/160010105011050/
1.60E+14,71,59,9,6,137,50,378,710,1466,2176,32.62867647,67.37132353,institutionalized,http://www.prisonersofthecensus.org/data/2010blocks/160010105011982/
1.60E+14,1,0,0,1,0,0,0,2,17,19,10.52631579,89.47368421,tract_part,http://www.prisonersofthecensus.org/data/2010blocks/160039502001733/
1.60E+14,4,24,2,1,29,8,44,112,225,337,33.23442136,66.76557864,tract_part,http://www.prisonersofthecensus.org/data/2010blocks/160050016032045/
1.60E+14,11,36,0,1,25,0,51,124,163,287,43.20557491,56.79442509,tract_part,http://www.prisonersofthecensus.org/data/2010blocks/160050006001019/
1.60E+14,0,0,0,0,0,0,0,0,5,5,0,100,tract_part,http://www.prisonersofthecensus.org/data/2010blocks/160099501002053/
1.60E+14,0,23,0,1,31,0,32,87,60,147,59.18367347,40.81632653,tract_part,http://www.prisonersofthecensus.org/data/2010blocks/160119505001078/
1.60E+14,1,5,0,0,1,0,3,10,86,96,10.41666667,89.58333333,tract_part,http://www.prisonersofthecensus.org/data/2010blocks/160179502006045/
1.60E+14,13,7,0,0,2,0,8,30,217,247,12.14574899,87.85425101,tract_part,http://www.prisonersofthecensus.org/data/2010blocks/160199707002062/
1.60E+14,1,4,0,0,3,1,14,23,63,86,26.74418605,73.25581395,tract_part,http://www.prisonersofthecensus.org/data/2010blocks/160199714002069/
1.60E+14,0,1,0,0,0,0,0,1,19,20,5,95,tract_part,http://www.prisonersofthecensus.org/data/2010blocks/160219702003042/
1.60E+14,0,0,0,0,0,0,0,0,2,2,0,100,tract_part,http://www.prisonersofthecensus.org/data/2010blocks/160239701003123/
1.60E+14,9,5,0,0,0,0,250,264,455,719,36.71766342,63.28233658,tract,http://www.prisonersofthecensus.org/data/2010blocks/160270213002031/
1.60E+14,1,1,0,0,2,2,14,20,66,86,23.25581395,76.74418605,tract_part,http://www.prisonersofthecensus.org/data/2010blocks/160270211002179/
1.60E+14,0,1,1,0,0,0,4,6,41,47,12.76595745,87.23404255,tract_part,http://www.prisonersofthecensus.org/data/2010blocks/160299602002400/
1.60E+14,4,5,0,0,31,7,59,106,65,171,61.98830409,38.01169591,tract_part,http://www.prisonersofthecensus.org/data/2010blocks/160319504003059/
1.60E+14,10,25,2,1,12,13,54,117,432,549,21.31147541,78.68852459,institutionalized,http://www.prisonersofthecensus.org/data/2010blocks/160359400002038/
1.60E+14,1,1,0,0,1,1,1,5,10,15,33.33333333,66.66666667,institutionalized,http://www.prisonersofthecensus.org/data/2010blocks/160359400004038/
1.60E+14,0,0,0,0,0,0,0,0,9,9,0,100,tract_part,http://www.prisonersofthecensus.org/data/2010blocks/160379602003477/
1.60E+14,2,1,0,1,0,0,39,43,51,94,45.74468085,54.25531915,tract_part,http://www.prisonersofthecensus.org/data/2010blocks/160399603001004/
1.60E+14,0,0,0,1,0,0,0,1,13,14,7.142857143,92.85714286,institutionalized,http://www.prisonersofthecensus.org/data/2010blocks/160439703004037/
1.60E+14,3,10,1,1,13,5,43,76,179,255,29.80392157,70.19607843,institutionalized,http://www.prisonersofthecensus.org/data/2010blocks/160439703005064/
1.60E+14,2,2,0,0,1,0,6,11,39,50,22,78,tract_part,http://www.prisonersofthecensus.org/data/2010blocks/160459603002010/
1.60E+14,0,1,0,0,0,1,10,12,23,35,34.28571429,65.71428571,institutionalized,http://www.prisonersofthecensus.org/data/2010blocks/160479601004094/
1.60E+14,0,0,0,0,0,0,1,1,0,1,100,0,institutionalized,http://www.prisonersofthecensus.org/data/2010blocks/160479601005034/
1.61E+14,8,20,1,1,13,7,34,84,346,430,19.53488372,80.46511628,tract_part,http://www.prisonersofthecensus.org/data/2010blocks/160499603002076/
1.61E+14,2,2,0,0,8,0,12,24,66,90,26.66666667,73.33333333,tract_part,http://www.prisonersofthecensus.org/data/2010blocks/160519603001039/
1.61E+14,1,1,0,0,10,0,19,31,34,65,47.69230769,52.30769231,tract_part,http://www.prisonersofthecensus.org/data/2010blocks/160539703001019/
1.61E+14,0,0,1,0,0,0,0,1,15,16,6.25,93.75,remaining,http://www.prisonersofthecensus.org/data/2010blocks/160550012001000/
1.61E+14,7,25,3,0,0,0,10,45,282,327,13.76146789,86.23853211,institutionalized,http://www.prisonersofthecensus.org/data/2010blocks/160550012001004/
1.61E+14,0,2,0,0,1,0,1,4,20,24,16.66666667,83.33333333,tract_part,http://www.prisonersofthecensus.org/data/2010blocks/160570051005020/
1.61E+14,0,1,0,0,1,0,3,5,29,34,14.70588235,85.29411765,institutionalized,http://www.prisonersofthecensus.org/data/2010blocks/160570054003038/
1.61E+14,0,0,0,0,0,1,1,2,26,28,7.142857143,92.85714286,institutionalized,http://www.prisonersofthecensus.org/data/2010blocks/160570054004005/
1.61E+14,0,0,0,0,0,0,0,0,9,9,0,100,tract_part,http://www.prisonersofthecensus.org/data/2010blocks/160599701001763/
1.61E+14,0,9,0,0,0,0,1,10,6,16,62.5,37.5,tract_part,http://www.prisonersofthecensus.org/data/2010blocks/160619400021146/
1.61E+14,0,4,0,0,4,0,27,35,52,87,40.22988506,59.77011494,tract_part,http://www.prisonersofthecensus.org/data/2010blocks/160659502001023/
1.61E+14,1,9,0,0,0,1,5,16,93,109,14.67889908,85.32110092,tract_part,http://www.prisonersofthecensus.org/data/2010blocks/160699603001125/
1.61E+14,0,0,0,0,0,0,5,5,0,5,100,0,tract_part,http://www.prisonersofthecensus.org/data/2010blocks/160739502002130/
1.61E+14,0,0,0,0,0,0,4,4,24,28,14.28571429,85.71428571,tract_part,http://www.prisonersofthecensus.org/data/2010blocks/160739502001937/
1.61E+14,0,0,0,0,0,0,16,16,39,55,29.09090909,70.90909091,tract_part,http://www.prisonersofthecensus.org/data/2010blocks/160759601004002/
1.61E+14,0,1,0,0,10,0,10,21,9,30,70,30,tract_part,http://www.prisonersofthecensus.org/data/2010blocks/160779602003069/
1.61E+14,1,0,0,0,0,0,3,4,56,60,6.666666667,93.33333333,tract_part,http://www.prisonersofthecensus.org/data/2010blocks/160799604003069/
1.61E+14,0,0,0,0,0,0,2,2,11,13,15.38461538,84.61538462,tract_part,http://www.prisonersofthecensus.org/data/2010blocks/160830010003015/
1.61E+14,0,0,0,0,0,0,0,0,11,11,0,100,institutionalized,http://www.prisonersofthecensus.org/data/2010blocks/160830011002029/
1.61E+14,1,1,0,1,17,10,57,87,169,256,33.984375,66.015625,institutionalized,http://www.prisonersofthecensus.org/data/2010blocks/160830011003012/
1.61E+14,0,2,0,1,2,1,13,19,66,85,22.35294118,77.64705882,tract_part,http://www.prisonersofthecensus.org/data/2010blocks/160830012001113/
1.61E+14,0,0,0,0,2,0,2,4,21,25,16,84,tract_part,http://www.prisonersofthecensus.org/data/2010blocks/160859701001305/
1.61E+14,0,1,0,0,5,0,26,32,17,49,65.30612245,34.69387755,tract_part,http://www.prisonersofthecensus.org/data/2010blocks/160879702002050/
1.70E+14,36,0,1,0,0,0,0,37,73,110,33.63636364,66.36363636,tract_part,http://www.prisonersofthecensus.org/data/2010blocks/170010007002034/
1.70E+14,242,1,0,0,79,0,79,401,89,490,81.83673469,18.16326531,tract_part,http://www.prisonersofthecensus.org/data/2010blocks/170039576001040/
1.70E+14,3,0,0,0,1,0,6,10,0,10,100,0,institutionalized,http://www.prisonersofthecensus.org/data/2010blocks/170059513004036/
1.70E+14,654,41,9,0,13,125,298,1140,500,1640,69.51219512,30.48780488,institutionalized,http://www.prisonersofthecensus.org/data/2010blocks/170059513005109/
1.70E+14,12,0,0,0,0,0,21,33,38,71,46.47887324,53.52112676,tract_part,http://www.prisonersofthecensus.org/data/2010blocks/170070101004001/
1.70E+14,1267,9,4,0,289,9,367,1945,419,2364,82.27580372,17.72419628,tract_part,http://www.prisonersofthecensus.org/data/2010blocks/170099705002112/
1.70E+14,4,0,0,0,0,0,4,8,10,18,44.44444444,55.55555556,tract_part,http://www.prisonersofthecensus.org/data/2010blocks/170119654003033/
1.70E+14,0,0,0,0,0,0,0,0,2,2,0,100,tract_part,http://www.prisonersofthecensus.org/data/2010blocks/170139512003023/
1.70E+14,1,0,0,0,2,0,2,5,19,24,20.83333333,79.16666667,tract_part,http://www.prisonersofthecensus.org/data/2010blocks/170159604002012/
1.70E+14,19,0,0,0,4,0,4,27,7,34,79.41176471,20.58823529,tract_part,http://www.prisonersofthecensus.org/data/2010blocks/170159606002084/
1.70E+14,2,0,0,0,0,0,0,2,8,10,20,80,tract,http://www.prisonersofthecensus.org/data/2010blocks/170190110005012/
1.70E+14,110,0,1,0,0,0,8,119,49,168,70.83333333,29.16666667,tract_part,http://www.prisonersofthecensus.org/data/2010blocks/170190055003016/
1.70E+14,43,0,0,0,0,0,3,46,21,67,68.65671642,31.34328358,tract_part,http://www.prisonersofthecensus.org/data/2010blocks/170190111001010/
1.70E+14,318,4,5,0,50,2,106,485,773,1258,38.55325914,61.44674086,tract_part,http://www.prisonersofthecensus.org/data/2010blocks/170219587003011/
1.70E+14,7,0,0,1,9,0,9,26,26,52,50,50,tract_part,http://www.prisonersofthecensus.org/data/2010blocks/170219584001023/
1.70E+14,0,0,0,0,0,0,0,0,6,6,0,100,tract_part,http://www.prisonersofthecensus.org/data/2010blocks/170230602003046/
1.70E+14,0,0,0,0,0,0,1,1,5,6,16.66666667,83.33333333,tract_part,http://www.prisonersofthecensus.org/data/2010blocks/170259720002052/
1.70E+14,902,6,1,0,126,5,195,1235,451,1686,73.25029656,26.74970344,tract_part,http://www.prisonersofthecensus.org/data/2010blocks/170279005001007/
1.70E+14,15,0,0,0,0,0,4,19,35,54,35.18518519,64.81481481,tract_part,http://www.prisonersofthecensus.org/data/2010blocks/170279004025029/
1.70E+14,17,0,0,0,1,2,3,23,84,107,21.4953271,78.5046729,tract_part,http://www.prisonersofthecensus.org/data/2010blocks/170290005006047/
1.70E+14,0,0,0,0,0,0,0,0,1,1,0,100,tract,http://www.prisonersofthecensus.org/data/2010blocks/170312425001019/
1.70E+14,47,1,0,0,0,4,1,53,1,54,98.14814815,1.851851852,tract,http://www.prisonersofthecensus.org/data/2010blocks/170312514002011/
1.70E+14,1,0,0,0,0,0,0,1,0,1,100,0,tract,http://www.prisonersofthecensus.org/data/2010blocks/170312520004000/
1.70E+14,123,0,0,0,0,2,3,128,1,129,99.2248062,0.775193798,tract,http://www.prisonersofthecensus.org/data/2010blocks/170312705001012/
1.70E+14,0,0,0,0,0,0,3,3,0,3,100,0,tract,http://www.prisonersofthecensus.org/data/2010blocks/170315101002031/
1.70E+14,2,0,0,0,0,0,0,2,0,2,100,0,tract,http://www.prisonersofthecensus.org/data/2010blocks/170315401011019/
1.70E+14,106,2,3,0,3,6,36,156,33,189,82.53968254,17.46031746,tract,http://www.prisonersofthecensus.org/data/2010blocks/170318331003023/
1.70E+14,219,0,3,0,7,1,44,274,58,332,82.53012048,17.46987952,tract,http://www.prisonersofthecensus.org/data/2010blocks/170318373002007/
1.70E+14,108,1,3,0,4,1,22,139,23,162,85.80246914,14.19753086,tract,http://www.prisonersofthecensus.org/data/2010blocks/170318378001017/
1.70E+14,147,0,4,0,3,0,26,180,32,212,84.90566038,15.09433962,tract,http://www.prisonersofthecensus.org/data/2010blocks/170318386002009/
1.70E+14,262,4,12,2,84,19,145,528,172,700,75.42857143,24.57142857,tract,http://www.prisonersofthecensus.org/data/2010blocks/170318391002022/
1.70E+14,124,0,0,0,10,6,26,166,11,177,93.78531073,6.214689266,institutionalized,http://www.prisonersofthecensus.org/data/2010blocks/170318435001000/
1.70E+14,7230,3,18,0,15,16,1159,8441,1409,9850,85.69543147,14.30456853,institutionalized,http://www.prisonersofthecensus.org/data/2010blocks/170318435001023/
1.70E+14,0,0,0,0,0,0,3,3,28,31,9.677419355,90.32258065,tract,http://www.prisonersofthecensus.org/data/2010blocks/170318090003024/
1.70E+14,2,0,0,0,0,0,1,3,20,23,13.04347826,86.95652174,tract_part,http://www.prisonersofthecensus.org/data/2010blocks/170338804001017/
1.70E+14,780,3,1,0,81,6,140,1011,290,1301,77.70945427,22.29054573,tract_part,http://www.prisonersofthecensus.org/data/2010blocks/170338805003070/
1.70E+14,0,0,0,0,0,0,0,0,5,5,0,100,tract_part,http://www.prisonersofthecensus.org/data/2010blocks/170359725003044/
1.70E+14,43,0,0,0,0,0,14,57,65,122,46.72131148,53.27868852,tract_part,http://www.prisonersofthecensus.org/data/2010blocks/170370006004043/
1.70E+14,29,0,0,0,0,0,6,35,41,76,46.05263158,53.94736842,tract_part,http://www.prisonersofthecensus.org/data/2010blocks/170399717002032/
1.70E+14,3,0,0,0,0,0,3,6,10,16,37.5,62.5,tract_part,http://www.prisonersofthecensus.org/data/2010blocks/170419522004128/
1.70E+14,36,1,1,0,7,5,13,63,33,96,65.625,34.375,tract_part,http://www.prisonersofthecensus.org/data/2010blocks/170438463072028/
1.70E+14,225,2,1,1,4,3,186,422,371,793,53.21563682,46.78436318,tract_part,http://www.prisonersofthecensus.org/data/2010blocks/170438426031026/
1.70E+14,6,0,0,0,0,0,0,6,27,33,18.18181818,81.81818182,tract_part,http://www.prisonersofthecensus.org/data/2010blocks/170450704002001/
1.71E+14,2,0,0,0,0,0,9,11,55,66,16.66666667,83.33333333,tract_part,http://www.prisonersofthecensus.org/data/2010blocks/170499508001064/
1.71E+14,919,2,3,0,64,7,124,1119,444,1563,71.59309021,28.40690979,tract_part,http://www.prisonersofthecensus.org/data/2010blocks/170519508002007/
1.71E+14,14,1,4,0,0,0,5,24,23,47,51.06382979,48.93617021,tract_part,http://www.prisonersofthecensus.org/data/2010blocks/170519509001027/
1.71E+14,22,0,0,0,2,0,3,27,18,45,60,40,tract_part,http://www.prisonersofthecensus.org/data/2010blocks/170539618002049/
1.71E+14,5,0,0,0,0,0,3,8,44,52,15.38461538,84.61538462,tract_part,http://www.prisonersofthecensus.org/data/2010blocks/170550406001053/
1.71E+14,1068,37,8,0,510,8,550,2181,433,2614,83.43534813,16.56465187,tract_part,http://www.prisonersofthecensus.org/data/2010blocks/170579535002006/
1.71E+14,18,0,0,0,3,0,3,24,52,76,31.57894737,68.42105263,tract_part,http://www.prisonersofthecensus.org/data/2010blocks/170579538001016/
1.71E+14,0,0,0,0,0,0,0,0,10,10,0,100,tract_part,http://www.prisonersofthecensus.org/data/2010blocks/170619740002074/
1.71E+14,102,0,1,0,0,0,14,117,76,193,60.62176166,39.37823834,tract_part,http://www.prisonersofthecensus.org/data/2010blocks/170619736001108/
1.71E+14,7,0,0,0,1,0,2,10,17,27,37.03703704,62.96296296,tract_part,http://www.prisonersofthecensus.org/data/2010blocks/170630004004084/
1.71E+14,0,0,0,0,0,0,0,0,10,10,0,100,tract_part,http://www.prisonersofthecensus.org/data/2010blocks/170679538002036/
1.71E+14,30,0,0,0,0,0,10,40,57,97,41.2371134,58.7628866,tract_part,http://www.prisonersofthecensus.org/data/2010blocks/170730302023030/
1.71E+14,78,1,0,0,11,0,11,101,115,216,46.75925926,53.24074074,tract_part,http://www.prisonersofthecensus.org/data/2010blocks/170730308001012/
1.71E+14,1,0,0,0,0,0,1,2,18,20,10,90,tract_part,http://www.prisonersofthecensus.org/data/2010blocks/170759504001071/
1.71E+14,22,0,0,0,0,0,0,22,40,62,35.48387097,64.51612903,tract,http://www.prisonersofthecensus.org/data/2010blocks/170770111004007/
1.71E+14,48,0,0,0,1,0,1,50,36,86,58.13953488,41.86046512,tract_part,http://www.prisonersofthecensus.org/data/2010blocks/170770107002040/
1.71E+14,0,0,0,0,0,0,0,0,4,4,0,100,tract_part,http://www.prisonersofthecensus.org/data/2010blocks/170799774001055/
1.71E+14,9,0,0,0,0,0,13,22,0,22,100,0,tract,http://www.prisonersofthecensus.org/data/2010blocks/170810510001066/
1.71E+14,803,7,6,0,117,5,211,1149,827,1976,58.14777328,41.85222672,tract_part,http://www.prisonersofthecensus.org/data/2010blocks/170810504003081/
1.71E+14,1,0,0,0,0,0,0,1,19,20,5,95,tract_part,http://www.prisonersofthecensus.org/data/2010blocks/170830104011013/
1.71E+14,1,0,0,0,0,0,0,1,12,13,7.692307692,92.30769231,tract_part,http://www.prisonersofthecensus.org/data/2010blocks/170850203003005/
1.71E+14,626,0,0,0,86,3,112,827,220,1047,78.98758357,21.01241643,institutionalized,http://www.prisonersofthecensus.org/data/2010blocks/170879800001002/
1.71E+14,342,0,1,0,52,3,61,459,139,598,76.75585284,23.24414716,institutionalized,http://www.prisonersofthecensus.org/data/2010blocks/170879800001007/
1.71E+14,57,3,1,0,4,1,10,76,52,128,59.375,40.625,tract_part,http://www.prisonersofthecensus.org/data/2010blocks/170898529053016/
1.71E+14,16,1,0,0,1,1,4,23,112,135,17.03703704,82.96296296,tract_part,http://www.prisonersofthecensus.org/data/2010blocks/170898529053002/
1.71E+14,205,1,1,6,23,2,280,518,152,670,77.31343284,22.68656716,tract_part,http://www.prisonersofthecensus.org/data/2010blocks/170898522023034/
1.71E+14,91,0,9,0,7,2,42,151,15,166,90.96385542,9.036144578,tract,http://www.prisonersofthecensus.org/data/2010blocks/170910123001021/
1.71E+14,1,0,0,0,0,0,0,1,92,93,1.075268817,98.92473118,tract_part,http://www.prisonersofthecensus.org/data/2010blocks/170910109001064/
1.71E+14,253,0,2,0,4,2,79,340,98,438,77.62557078,22.37442922,tract_part,http://www.prisonersofthecensus.org/data/2010blocks/170910126003042/
1.71E+14,16,1,0,0,1,1,15,34,30,64,53.125,46.875,tract_part,http://www.prisonersofthecensus.org/data/2010blocks/170938904001307/
1.71E+14,1150,14,7,0,281,4,309,1765,374,2139,82.51519402,17.48480598,tract_part,http://www.prisonersofthecensus.org/data/2010blocks/170950005002028/
1.71E+14,28,0,1,0,0,0,3,32,58,90,35.55555556,64.44444444,tract,http://www.prisonersofthecensus.org/data/2010blocks/170950008002010/
1.71E+14,1,0,0,0,0,0,0,1,2,3,33.33333333,66.66666667,tract_part,http://www.prisonersofthecensus.org/data/2010blocks/170978630031006/
1.71E+14,259,5,4,0,31,10,148,457,282,739,61.84032476,38.15967524,tract_part,http://www.prisonersofthecensus.org/data/2010blocks/170978622002054/
1.71E+14,31,1,1,0,7,6,27,73,115,188,38.82978723,61.17021277,tract_part,http://www.prisonersofthecensus.org/data/2010blocks/170999626001029/
1.71E+14,911,4,1,0,49,3,140,1108,290,1398,79.25608011,20.74391989,tract_part,http://www.prisonersofthecensus.org/data/2010blocks/170999623001087/
1.71E+14,1490,5,8,0,220,18,393,2134,486,2620,81.45038168,18.54961832,tract_part,http://www.prisonersofthecensus.org/data/2010blocks/171018808001019/
1.71E+14,7,0,0,0,0,0,3,10,30,40,25,75,tract_part,http://www.prisonersofthecensus.org/data/2010blocks/171030003003002/
1.71E+14,1175,5,10,0,229,9,321,1749,739,2488,70.29742765,29.70257235,tract_part,http://www.prisonersofthecensus.org/data/2010blocks/171030004002049/
1.71E+14,577,9,7,0,18,3,82,696,432,1128,61.70212766,38.29787234,tract_part,http://www.prisonersofthecensus.org/data/2010blocks/171059602003043/
1.71E+14,998,7,12,0,35,6,211,1269,449,1718,73.86495925,26.13504075,institutionalized,http://www.prisonersofthecensus.org/data/2010blocks/171059607004004/
1.71E+14,2,0,0,0,0,0,1,3,20,23,13.04347826,86.95652174,institutionalized,http://www.prisonersofthecensus.org/data/2010blocks/171059607004013/
1.71E+14,0,0,0,0,0,0,0,0,4,4,0,100,tract_part,http://www.prisonersofthecensus.org/data/2010blocks/171059608001040/
1.71E+14,1700,10,10,0,243,9,389,2361,940,3301,71.52378067,28.47621933,tract_part,http://www.prisonersofthecensus.org/data/2010blocks/171079535001009/
1.71E+14,5,0,0,0,0,0,0,5,23,28,17.85714286,82.14285714,tract_part,http://www.prisonersofthecensus.org/data/2010blocks/171079532004028/
1.71E+14,80,0,11,1,36,11,161,300,280,580,51.72413793,48.27586207,tract_part,http://www.prisonersofthecensus.org/data/2010blocks/171118704021007/
1.71E+14,105,4,0,0,4,5,23,141,104,245,57.55102041,42.44897959,tract,http://www.prisonersofthecensus.org/data/2010blocks/171130016002022/
1.71E+14,31,0,0,0,0,0,7,38,74,112,33.92857143,66.07142857,tract_part,http://www.prisonersofthecensus.org/data/2010blocks/171150021002000/
1.71E+14,150,0,0,0,0,0,1,151,87,238,63.44537815,36.55462185,tract,http://www.prisonersofthecensus.org/data/2010blocks/171150031001082/
1.71E+14,191,0,4,0,5,1,34,235,272,507,46.35108481,53.64891519,tract_part,http://www.prisonersofthecensus.org/data/2010blocks/171150029032023/
1.71E+14,0,0,0,0,0,0,1,1,16,17,5.882352941,94.11764706,tract_part,http://www.prisonersofthecensus.org/data/2010blocks/171179564005013/
1.71E+14,11,0,0,0,0,0,14,25,0,25,100,0,tract_part,http://www.prisonersofthecensus.org/data/2010blocks/171194024001094/
1.71E+14,37,0,0,0,4,0,10,51,69,120,42.5,57.5,tract_part,http://www.prisonersofthecensus.org/data/2010blocks/171219521001023/
1.71E+14,1,0,0,0,0,0,0,1,6,7,14.28571429,85.71428571,tract_part,http://www.prisonersofthecensus.org/data/2010blocks/171239614001101/
1.71E+14,11,1,0,0,2,0,3,17,26,43,39.53488372,60.46511628,tract_part,http://www.prisonersofthecensus.org/data/2010blocks/171259565002014/
1.71E+14,2,0,1,0,2,0,3,8,10,18,44.44444444,55.55555556,tract_part,http://www.prisonersofthecensus.org/data/2010blocks/171290102003038/
1.71E+14,11,0,0,0,0,1,4,16,24,40,40,60,tract_part,http://www.prisonersofthecensus.org/data/2010blocks/171310403003009/
1.71E+14,807,4,4,0,23,1,111,950,967,1917,49.55659885,50.44340115,tract_part,http://www.prisonersofthecensus.org/data/2010blocks/171359580003052/
1.71E+14,5,0,0,0,1,0,1,7,19,26,26.92307692,73.07692308,tract_part,http://www.prisonersofthecensus.org/data/2010blocks/171359579001095/
1.71E+14,11,0,0,0,0,0,0,11,24,35,31.42857143,68.57142857,tract_part,http://www.prisonersofthecensus.org/data/2010blocks/171379517003034/
1.71E+14,603,2,3,0,83,2,123,816,264,1080,75.55555556,24.44444444,tract_part,http://www.prisonersofthecensus.org/data/2010blocks/171379520003001/
1.71E+14,10,0,0,0,1,0,3,14,17,31,45.16129032,54.83870968,tract_part,http://www.prisonersofthecensus.org/data/2010blocks/171399772004019/
1.71E+14,23,0,0,0,1,0,18,42,40,82,51.2195122,48.7804878,tract_part,http://www.prisonersofthecensus.org/data/2010blocks/171419614004017/
1.71E+14,300,0,0,0,6,0,9,315,127,442,71.26696833,28.73303167,tract_part,http://www.prisonersofthecensus.org/data/2010blocks/171430045001010/
1.71E+14,53,4,1,0,54,0,56,168,86,254,66.14173228,33.85826772,tract,http://www.prisonersofthecensus.org/data/2010blocks/171430012001066/
1.71E+14,1381,8,6,1,321,5,349,2071,538,2609,79.37907244,20.62092756,institutionalized,http://www.prisonersofthecensus.org/data/2010blocks/171450302003048/
1.71E+14,17,0,0,0,1,0,3,21,23,44,47.72727273,52.27272727,institutionalized,http://www.prisonersofthecensus.org/data/2010blocks/171450302005027/
1.72E+14,234,2,2,0,2,1,27,268,120,388,69.07216495,30.92783505,institutionalized,http://www.prisonersofthecensus.org/data/2010blocks/171499527003093/
1.72E+14,9,0,0,0,1,0,1,11,30,41,26.82926829,73.17073171,institutionalized,http://www.prisonersofthecensus.org/data/2010blocks/171499527005021/
1.72E+14,103,0,1,0,15,0,15,134,54,188,71.27659574,28.72340426,tract_part,http://www.prisonersofthecensus.org/data/2010blocks/171519712002096/
1.72E+14,3,0,0,0,0,0,0,3,3,6,50,50,tract_part,http://www.prisonersofthecensus.org/data/2010blocks/171539711002034/
1.72E+14,0,0,0,0,0,0,0,0,2,2,0,100,tract_part,http://www.prisonersofthecensus.org/data/2010blocks/171559546001092/
1.72E+14,2000,7,8,1,197,7,351,2571,763,3334,77.11457708,22.88542292,institutionalized,http://www.prisonersofthecensus.org/data/2010blocks/171579512001094/
1.72E+14,250,1,1,0,5,1,26,284,171,455,62.41758242,37.58241758,institutionalized,http://www.prisonersofthecensus.org/data/2010blocks/171579512001117/
1.72E+14,1,0,0,0,1,1,2,5,25,30,16.66666667,83.33333333,tract_part,http://www.prisonersofthecensus.org/data/2010blocks/171599782001008/
1.72E+14,681,3,1,0,81,4,139,909,300,1209,75.18610422,24.81389578,tract_part,http://www.prisonersofthecensus.org/data/2010blocks/171610204002067/
1.72E+14,105,2,2,0,12,2,36,159,90,249,63.85542169,36.14457831,tract,http://www.prisonersofthecensus.org/data/2010blocks/171610226002010/
1.72E+14,0,0,0,0,0,0,0,0,1,1,0,100,tract,http://www.prisonersofthecensus.org/data/2010blocks/171610233001001/
1.72E+14,291,0,0,0,0,0,3,294,92,386,76.16580311,23.83419689,tract_part,http://www.prisonersofthecensus.org/data/2010blocks/171635017002008/
1.72E+14,380,1,1,0,7,0,32,421,287,708,59.46327684,40.53672316,tract_part,http://www.prisonersofthecensus.org/data/2010blocks/171635024042102/
1.72E+14,19,0,0,0,0,0,1,20,0,20,100,0,tract,http://www.prisonersofthecensus.org/data/2010blocks/171635009001040/
1.72E+14,13,0,0,0,1,0,1,15,55,70,21.42857143,78.57142857,tract_part,http://www.prisonersofthecensus.org/data/2010blocks/171659559002023/
1.72E+14,6,0,0,0,1,0,1,8,8,16,50,50,tract,http://www.prisonersofthecensus.org/data/2010blocks/171670009001020/
1.72E+14,169,0,1,0,8,1,12,191,114,305,62.62295082,37.37704918,tract,http://www.prisonersofthecensus.org/data/2010blocks/171670014001024/
1.72E+14,1,0,0,0,1,0,3,5,6,11,45.45454545,54.54545455,tract_part,http://www.prisonersofthecensus.org/data/2010blocks/171699702003022/
1.72E+14,1,0,0,0,0,0,0,1,7,8,12.5,87.5,tract_part,http://www.prisonersofthecensus.org/data/2010blocks/171739593005094/
1.72E+14,0,0,0,0,0,0,0,0,2,2,0,100,tract_part,http://www.prisonersofthecensus.org/data/2010blocks/171759514005046/
1.72E+14,59,0,0,0,0,0,4,63,45,108,58.33333333,41.66666667,tract_part,http://www.prisonersofthecensus.org/data/2010blocks/171770007002037/
1.72E+14,597,68,14,1,151,49,320,1200,630,1830,65.57377049,34.42622951,tract_part,http://www.prisonersofthecensus.org/data/2010blocks/171790218012006/
1.72E+14,106,0,0,0,0,0,7,113,132,245,46.12244898,53.87755102,tract_part,http://www.prisonersofthecensus.org/data/2010blocks/171830001002014/
1.72E+14,1130,5,5,0,56,5,312,1513,404,1917,78.92540428,21.07459572,tract_part,http://www.prisonersofthecensus.org/data/2010blocks/171830112001079/
1.72E+14,1,0,0,0,0,0,0,1,16,17,5.882352941,94.11764706,tract_part,http://www.prisonersofthecensus.org/data/2010blocks/171878704004085/
1.72E+14,9,0,0,0,0,0,1,10,8,18,55.55555556,44.44444444,tract_part,http://www.prisonersofthecensus.org/data/2010blocks/171899503001078/
1.72E+14,2,0,0,0,0,0,2,4,0,4,100,0,tract_part,http://www.prisonersofthecensus.org/data/2010blocks/171919551003045/
1.72E+14,19,0,0,0,0,0,36,55,35,90,61.11111111,38.88888889,tract_part,http://www.prisonersofthecensus.org/data/2010blocks/171939580001085/
1.72E+14,21,0,0,0,12,0,12,45,55,100,45,55,tract_part,http://www.prisonersofthecensus.org/data/2010blocks/171950002003038/
1.72E+14,343,0,4,0,115,2,117,581,276,857,67.79463244,32.20536756,tract,http://www.prisonersofthecensus.org/data/2010blocks/171978820003045/
1.72E+14,2185,6,10,0,27,13,421,2662,535,3197,83.26556146,16.73443854,tract_part,http://www.prisonersofthecensus.org/data/2010blocks/171979801001006/
1.72E+14,388,50,2,0,22,2,105,569,461,1030,55.24271845,44.75728155,tract_part,http://www.prisonersofthecensus.org/data/2010blocks/171990214003144/
1.72E+14,127,0,0,0,19,2,25,173,54,227,76.21145374,23.78854626,tract_part,http://www.prisonersofthecensus.org/data/2010blocks/171990210003002/
1.72E+14,391,1,4,0,2,1,92,491,472,963,50.98650052,49.01349948,tract,http://www.prisonersofthecensus.org/data/2010blocks/172010026002024/
1.72E+14,2,0,0,0,1,1,3,7,38,45,15.55555556,84.44444444,tract_part,http://www.prisonersofthecensus.org/data/2010blocks/172030306013093/
1.80E+14,2,0,0,0,1,0,5,8,86,94,8.510638298,91.4893617,tract_part,http://www.prisonersofthecensus.org/data/2010blocks/180010303004000/
1.80E+14,2,0,0,0,0,0,0,2,1,3,66.66666667,33.33333333,tract_part,http://www.prisonersofthecensus.org/data/2010blocks/180030113022021/
1.80E+14,19,0,0,0,4,2,8,33,45,78,42.30769231,57.69230769,tract_part,http://www.prisonersofthecensus.org/data/2010blocks/180030103073015/
1.80E+14,0,0,3,0,0,0,0,3,8,11,27.27272727,72.72727273,tract_part,http://www.prisonersofthecensus.org/data/2010blocks/180030041032005/
1.80E+14,17,0,0,0,1,0,1,19,30,49,38.7755102,61.2244898,tract_part,http://www.prisonersofthecensus.org/data/2010blocks/180030106021009/
1.80E+14,238,3,4,0,24,19,49,337,467,804,41.91542289,58.08457711,tract,http://www.prisonersofthecensus.org/data/2010blocks/180030013001003/
1.80E+14,0,0,0,0,2,0,0,2,4,6,33.33333333,66.66666667,tract,http://www.prisonersofthecensus.org/data/2010blocks/180030020003009/
1.80E+14,2,0,1,0,0,0,0,3,4,7,42.85714286,57.14285714,tract,http://www.prisonersofthecensus.org/data/2010blocks/180030028002007/
1.80E+14,21,0,0,0,23,2,24,70,127,197,35.53299492,64.46700508,tract_part,http://www.prisonersofthecensus.org/data/2010blocks/180050101004087/
1.80E+14,0,0,0,0,0,0,1,1,20,21,4.761904762,95.23809524,tract_part,http://www.prisonersofthecensus.org/data/2010blocks/180071002004004/
1.80E+14,15,0,0,0,0,1,1,17,74,91,18.68131868,81.31868132,tract_part,http://www.prisonersofthecensus.org/data/2010blocks/180099754001037/
1.80E+14,0,0,0,0,0,0,0,0,1,1,0,100,tract_part,http://www.prisonersofthecensus.org/data/2010blocks/180099753001007/
1.80E+14,14,0,0,0,6,0,7,27,116,143,18.88111888,81.11888112,tract_part,http://www.prisonersofthecensus.org/data/2010blocks/180118103003020/
1.80E+14,1,0,0,0,0,0,7,8,31,39,20.51282051,79.48717949,tract_part,http://www.prisonersofthecensus.org/data/2010blocks/180159596001078/
1.80E+14,18,3,1,1,12,1,31,67,123,190,35.26315789,64.73684211,tract_part,http://www.prisonersofthecensus.org/data/2010blocks/180179514001009/
1.80E+14,120,0,0,0,2,3,14,139,244,383,36.2924282,63.7075718,tract_part,http://www.prisonersofthecensus.org/data/2010blocks/180190502003051/
1.80E+14,36,0,0,0,1,0,4,41,154,195,21.02564103,78.97435897,tract_part,http://www.prisonersofthecensus.org/data/2010blocks/180190508032007/
1.80E+14,2,0,0,0,0,0,14,16,0,16,100,0,tract_part,http://www.prisonersofthecensus.org/data/2010blocks/180210402002045/
1.80E+14,7,0,0,0,0,0,3,10,67,77,12.98701299,87.01298701,tract_part,http://www.prisonersofthecensus.org/data/2010blocks/180210402007004/
1.80E+14,11,2,0,0,1,0,32,46,135,181,25.41436464,74.58563536,tract_part,http://www.prisonersofthecensus.org/data/2010blocks/180239508001011/
1.80E+14,11,1,0,0,10,1,14,37,165,202,18.31683168,81.68316832,tract_part,http://www.prisonersofthecensus.org/data/2010blocks/180279548002024/
1.80E+14,13,0,0,0,0,2,1,16,232,248,6.451612903,93.5483871,tract_part,http://www.prisonersofthecensus.org/data/2010blocks/180290803005036/
1.80E+14,1,0,0,0,0,0,5,6,52,58,10.34482759,89.65517241,tract_part,http://www.prisonersofthecensus.org/data/2010blocks/180319694003031/
1.80E+14,3,0,0,0,0,0,0,3,73,76,3.947368421,96.05263158,tract_part,http://www.prisonersofthecensus.org/data/2010blocks/180330205003018/
1.80E+14,113,0,0,0,0,0,5,118,179,297,39.73063973,60.26936027,tract,http://www.prisonersofthecensus.org/data/2010blocks/180350028001009/
1.80E+14,3,0,0,0,9,0,16,28,140,168,16.66666667,83.33333333,tract_part,http://www.prisonersofthecensus.org/data/2010blocks/180379534004018/
1.80E+14,85,1,0,0,0,1,24,111,192,303,36.63366337,63.36633663,tract_part,http://www.prisonersofthecensus.org/data/2010blocks/180390002004050/
1.80E+14,271,1,2,0,24,9,121,428,598,1026,41.71539961,58.28460039,tract_part,http://www.prisonersofthecensus.org/data/2010blocks/180390013002017/
1.80E+14,55,1,0,0,1,6,7,70,219,289,24.22145329,75.77854671,tract,http://www.prisonersofthecensus.org/data/2010blocks/180430705002043/
1.80E+14,1,1,0,0,2,0,2,6,17,23,26.08695652,73.91304348,tract_part,http://www.prisonersofthecensus.org/data/2010blocks/180459578003051/
1.81E+14,1,0,0,0,0,1,1,3,68,71,4.225352113,95.77464789,tract_part,http://www.prisonersofthecensus.org/data/2010blocks/180499531001043/
1.81E+14,19,0,0,0,1,1,4,25,155,180,13.88888889,86.11111111,tract_part,http://www.prisonersofthecensus.org/data/2010blocks/180510505013004/
1.81E+14,79,0,0,1,0,1,10,91,178,269,33.82899628,66.17100372,tract,http://www.prisonersofthecensus.org/data/2010blocks/180530001002024/
1.81E+14,0,0,0,0,0,0,0,0,31,31,0,100,institutionalized,http://www.prisonersofthecensus.org/data/2010blocks/180559554001026/
1.81E+14,0,0,0,0,0,0,0,0,76,76,0,100,institutionalized,http://www.prisonersofthecensus.org/data/2010blocks/180559554001039/
1.81E+14,66,0,0,0,2,1,6,75,238,313,23.96166134,76.03833866,tract_part,http://www.prisonersofthecensus.org/data/2010blocks/180571106003007/
1.81E+14,18,0,2,0,0,1,0,21,147,168,12.5,87.5,tract_part,http://www.prisonersofthecensus.org/data/2010blocks/180594105002023/
1.81E+14,4,1,0,0,3,1,4,13,147,160,8.125,91.875,tract_part,http://www.prisonersofthecensus.org/data/2010blocks/180610603001038/
1.81E+14,987,2,3,0,83,3,136,1214,1319,2533,47.92735886,52.07264114,tract_part,http://www.prisonersofthecensus.org/data/2010blocks/180632107002030/
1.81E+14,13,0,0,0,0,0,2,15,98,113,13.27433628,86.72566372,institutionalized,http://www.prisonersofthecensus.org/data/2010blocks/180659760002002/
1.81E+14,3,0,0,0,0,0,1,4,63,67,5.970149254,94.02985075,institutionalized,http://www.prisonersofthecensus.org/data/2010blocks/180659760002015/
1.81E+14,635,7,3,0,38,4,117,804,1609,2413,33.31951927,66.68048073,tract_part,http://www.prisonersofthecensus.org/data/2010blocks/180659755003005/
1.81E+14,90,4,1,0,7,12,14,128,224,352,36.36363636,63.63636364,tract_part,http://www.prisonersofthecensus.org/data/2010blocks/180670007002030/
1.81E+14,5,4,0,0,4,5,10,28,101,129,21.70542636,78.29457364,tract_part,http://www.prisonersofthecensus.org/data/2010blocks/180699616003056/
1.81E+14,1,1,0,0,0,0,14,16,150,166,9.638554217,90.36144578,tract_part,http://www.prisonersofthecensus.org/data/2010blocks/180719681002060/
1.81E+14,3,0,0,0,1,2,6,12,66,78,15.38461538,84.61538462,tract_part,http://www.prisonersofthecensus.org/data/2010blocks/180731012001101/
1.81E+14,2,1,0,0,0,0,1,4,15,19,21.05263158,78.94736842,tract_part,http://www.prisonersofthecensus.org/data/2010blocks/180731011002075/
1.81E+14,0,0,0,0,0,0,2,2,43,45,4.444444444,95.55555556,tract_part,http://www.prisonersofthecensus.org/data/2010blocks/180759631004017/
1.81E+14,124,2,1,0,11,2,19,159,442,601,26.45590682,73.54409318,tract_part,http://www.prisonersofthecensus.org/data/2010blocks/180779664003114/
1.81E+14,7,0,0,0,2,0,2,11,71,82,13.41463415,86.58536585,tract,http://www.prisonersofthecensus.org/data/2010blocks/180779666001040/
1.81E+14,2,0,0,0,0,0,2,4,126,130,3.076923077,96.92307692,tract_part,http://www.prisonersofthecensus.org/data/2010blocks/180799602002021/
1.81E+14,18,0,0,0,0,0,11,29,211,240,12.08333333,87.91666667,tract_part,http://www.prisonersofthecensus.org/data/2010blocks/180816108014022/
1.81E+14,94,0,0,0,2,0,4,100,220,320,31.25,68.75,tract_part,http://www.prisonersofthecensus.org/data/2010blocks/180816114005180/
1.81E+14,4,0,0,0,0,0,0,4,71,75,5.333333333,94.66666667,tract,http://www.prisonersofthecensus.org/data/2010blocks/180839554003037/
1.81E+14,19,0,1,0,0,4,3,27,194,221,12.21719457,87.78280543,tract_part,http://www.prisonersofthecensus.org/data/2010blocks/180839559001080/
1.81E+14,11,1,0,0,3,0,25,40,186,226,17.69911504,82.30088496,tract,http://www.prisonersofthecensus.org/data/2010blocks/180859619002028/
1.81E+14,0,0,0,0,0,0,1,1,34,35,2.857142857,97.14285714,tract_part,http://www.prisonersofthecensus.org/data/2010blocks/180859620003007/
1.81E+14,3,0,0,0,0,0,2,5,1,6,83.33333333,16.66666667,tract,http://www.prisonersofthecensus.org/data/2010blocks/180890207004015/
1.81E+14,521,3,0,0,39,21,150,734,604,1338,54.85799701,45.14200299,tract_part,http://www.prisonersofthecensus.org/data/2010blocks/180890425041014/
1.81E+14,56,0,0,0,5,0,14,75,54,129,58.13953488,41.86046512,tract_part,http://www.prisonersofthecensus.org/data/2010blocks/180890425052026/
1.81E+14,170,1,3,0,5,9,14,202,145,347,58.21325648,41.78674352,tract,http://www.prisonersofthecensus.org/data/2010blocks/180910423002014/
1.81E+14,422,1,1,0,10,5,37,476,356,832,57.21153846,42.78846154,institutionalized,http://www.prisonersofthecensus.org/data/2010blocks/180910401002000/
1.81E+14,704,5,3,0,36,1,85,834,604,1438,57.99721836,42.00278164,institutionalized,http://www.prisonersofthecensus.org/data/2010blocks/180910401002001/
1.81E+14,33,0,0,0,1,0,7,41,12,53,77.35849057,22.64150943,tract,http://www.prisonersofthecensus.org/data/2010blocks/180910430002069/
1.81E+14,1443,5,5,0,82,5,238,1778,1487,3265,54.45635528,45.54364472,tract_part,http://www.prisonersofthecensus.org/data/2010blocks/180910426003013/
1.81E+14,2,2,0,0,2,0,6,12,148,160,7.5,92.5,tract_part,http://www.prisonersofthecensus.org/data/2010blocks/180939510001021/
1.81E+14,49,0,0,0,2,0,5,56,120,176,31.81818182,68.18181818,tract,http://www.prisonersofthecensus.org/data/2010blocks/180950003001045/
1.81E+14,27,0,0,0,0,2,4,33,64,97,34.02061856,65.97938144,institutionalized,http://www.prisonersofthecensus.org/data/2010blocks/180950119002026/
1.81E+14,20,0,0,1,0,0,1,22,68,90,24.44444444,75.55555556,institutionalized,http://www.prisonersofthecensus.org/data/2010blocks/180950119002030/
1.81E+14,895,5,3,2,24,1,70,1000,916,1916,52.19206681,47.80793319,institutionalized,http://www.prisonersofthecensus.org/data/2010blocks/180950116001015/
1.81E+14,612,4,2,2,32,3,93,748,748,1496,50,50,institutionalized,http://www.prisonersofthecensus.org/data/2010blocks/180950116001016/
1.81E+14,122,0,0,0,2,2,6,132,42,174,75.86206897,24.13793103,tract,http://www.prisonersofthecensus.org/data/2010blocks/180973521002008/
1.81E+14,66,0,0,0,0,2,2,70,33,103,67.96116505,32.03883495,tract,http://www.prisonersofthecensus.org/data/2010blocks/180973533003002/
1.81E+14,83,0,0,0,3,4,10,100,77,177,56.49717514,43.50282486,institutionalized,http://www.prisonersofthecensus.org/data/2010blocks/180973542003081/
1.81E+14,662,0,2,0,0,2,19,685,341,1026,66.76413255,33.23586745,institutionalized,http://www.prisonersofthecensus.org/data/2010blocks/180973542003092/
1.81E+14,171,0,0,0,1,0,4,176,148,324,54.32098765,45.67901235,tract,http://www.prisonersofthecensus.org/data/2010blocks/180973545001000/
1.81E+14,79,0,0,0,0,0,0,79,81,160,49.375,50.625,institutionalized,http://www.prisonersofthecensus.org/data/2010blocks/180973562002000/
1.81E+14,491,2,2,0,34,24,115,668,284,952,70.16806723,29.83193277,institutionalized,http://www.prisonersofthecensus.org/data/2010blocks/180973562002008/
1.81E+14,37,1,0,0,0,2,3,43,62,105,40.95238095,59.04761905,institutionalized,http://www.prisonersofthecensus.org/data/2010blocks/180973910001063/
1.81E+14,31,0,2,0,1,0,3,37,28,65,56.92307692,43.07692308,institutionalized,http://www.prisonersofthecensus.org/data/2010blocks/180973910001100/
1.81E+14,35,0,0,0,1,0,3,39,87,126,30.95238095,69.04761905,institutionalized,http://www.prisonersofthecensus.org/data/2010blocks/180973910003143/
1.81E+14,2,0,0,0,2,0,3,7,0,7,100,0,tract,http://www.prisonersofthecensus.org/data/2010blocks/180973606023001/
1.81E+14,17,0,0,0,1,0,1,19,50,69,27.53623188,72.46376812,tract,http://www.prisonersofthecensus.org/data/2010blocks/180973401112001/
1.81E+14,3,0,0,0,0,2,5,10,90,100,10,90,tract_part,http://www.prisonersofthecensus.org/data/2010blocks/180990205001010/
1.81E+14,1141,6,2,2,33,2,174,1360,1798,3158,43.06523116,56.93476884,tract_part,http://www.prisonersofthecensus.org/data/2010blocks/181039529001067/
1.81E+14,11,3,0,0,0,0,4,18,71,89,20.2247191,79.7752809,tract_part,http://www.prisonersofthecensus.org/data/2010blocks/181039521004020/
1.81E+14,55,1,1,0,0,0,3,60,181,241,24.89626556,75.10373444,tract_part,http://www.prisonersofthecensus.org/data/2010blocks/181050001001005/
1.81E+14,0,0,0,0,0,0,0,0,2,2,0,100,tract_part,http://www.prisonersofthecensus.org/data/2010blocks/181050014025015/
1.81E+14,11,0,0,0,0,3,10,24,162,186,12.90322581,87.09677419,tract_part,http://www.prisonersofthecensus.org/data/2010blocks/181079571001004/
1.81E+14,4,0,0,0,1,3,3,11,217,228,4.824561404,95.1754386,tract_part,http://www.prisonersofthecensus.org/data/2010blocks/181095107021100/
1.81E+14,1,1,0,0,0,0,3,5,35,40,12.5,87.5,tract_part,http://www.prisonersofthecensus.org/data/2010blocks/181111007001077/
1.81E+14,2,0,0,0,0,0,19,21,155,176,11.93181818,88.06818182,tract_part,http://www.prisonersofthecensus.org/data/2010blocks/181139724004014/
1.81E+14,32,0,2,0,2,0,7,43,108,151,28.47682119,71.52317881,tract_part,http://www.prisonersofthecensus.org/data/2010blocks/181139726001044/
1.81E+14,4,0,0,0,0,0,0,4,75,79,5.063291139,94.93670886,tract_part,http://www.prisonersofthecensus.org/data/2010blocks/181179517003033/
1.81E+14,0,0,0,0,0,0,0,0,62,62,0,100,tract_part,http://www.prisonersofthecensus.org/data/2010blocks/181199558002047/
1.81E+14,4,0,0,0,0,1,1,6,82,88,6.818181818,93.18181818,remaining,http://www.prisonersofthecensus.org/data/2010blocks/181210303003004/
1.81E+14,337,3,0,0,23,2,33,398,922,1320,30.15151515,69.84848485,institutionalized,http://www.prisonersofthecensus.org/data/2010blocks/181210303004003/
1.81E+14,2,0,0,0,0,0,3,5,68,73,6.849315068,93.15068493,tract_part,http://www.prisonersofthecensus.org/data/2010blocks/181210304004023/
1.81E+14,429,0,5,0,9,0,26,469,863,1332,35.21021021,64.78978979,tract_part,http://www.prisonersofthecensus.org/data/2010blocks/181239522003002/
1.81E+14,0,0,0,0,0,0,0,0,29,29,0,100,tract_part,http://www.prisonersofthecensus.org/data/2010blocks/181239526001067/
1.81E+14,8,0,0,0,1,0,1,10,64,74,13.51351351,86.48648649,tract_part,http://www.prisonersofthecensus.org/data/2010blocks/181259540003082/
1.81E+14,65,3,0,0,0,2,56,126,382,508,24.80314961,75.19685039,tract_part,http://www.prisonersofthecensus.org/data/2010blocks/181270510023099/
1.81E+14,5,0,0,0,0,0,0,5,49,54,9.259259259,90.74074074,tract_part,http://www.prisonersofthecensus.org/data/2010blocks/181290405003078/
1.81E+14,7,1,0,0,0,3,1,12,105,117,10.25641026,89.74358974,tract_part,http://www.prisonersofthecensus.org/data/2010blocks/181319590002042/
1.81E+14,21,0,0,0,0,1,2,24,149,173,13.87283237,86.12716763,tract_part,http://www.prisonersofthecensus.org/data/2010blocks/181339563005018/
1.81E+14,1099,4,2,3,56,7,111,1282,1407,2689,47.67571588,52.32428412,tract_part,http://www.prisonersofthecensus.org/data/2010blocks/181339566003009/
1.81E+14,1,0,0,0,0,0,8,9,91,100,9,91,tract_part,http://www.prisonersofthecensus.org/data/2010blocks/181359518002049/
1.81E+14,5,0,0,0,0,1,1,7,75,82,8.536585366,91.46341463,tract_part,http://www.prisonersofthecensus.org/data/2010blocks/181379688002030/
1.81E+14,0,0,0,0,1,0,4,5,39,44,11.36363636,88.63636364,tract_part,http://www.prisonersofthecensus.org/data/2010blocks/181399744003022/
1.81E+14,329,1,2,0,0,5,41,378,214,592,63.85135135,36.14864865,tract,http://www.prisonersofthecensus.org/data/2010blocks/181410027001003/
1.81E+14,37,1,0,0,0,0,1,39,63,102,38.23529412,61.76470588,tract,http://www.prisonersofthecensus.org/data/2010blocks/181410033004003/
1.81E+14,0,0,0,0,0,0,0,0,8,8,0,100,tract_part,http://www.prisonersofthecensus.org/data/2010blocks/181439670001023/
1.81E+14,0,0,0,0,0,0,5,5,86,91,5.494505495,94.50549451,tract_part,http://www.prisonersofthecensus.org/data/2010blocks/181439671003023/
1.81E+14,14,0,0,0,3,3,7,27,189,216,12.5,87.5,tract,http://www.prisonersofthecensus.org/data/2010blocks/181457106022008/
1.81E+14,3,0,0,0,0,0,2,5,55,60,8.333333333,91.66666667,tract_part,http://www.prisonersofthecensus.org/data/2010blocks/181479531002036/
1.82E+14,4,1,0,0,0,0,7,12,102,114,10.52631579,89.47368421,tract_part,http://www.prisonersofthecensus.org/data/2010blocks/181519714002024/
1.82E+14,927,4,1,1,17,1,104,1055,1130,2185,48.28375286,51.71624714,tract_part,http://www.prisonersofthecensus.org/data/2010blocks/181530505002055/
1.82E+14,0,0,0,0,0,0,0,0,42,42,0,100,tract_part,http://www.prisonersofthecensus.org/data/2010blocks/181559659002043/
1.82E+14,81,2,0,0,15,6,35,139,369,508,27.36220472,72.63779528,tract_part,http://www.prisonersofthecensus.org/data/2010blocks/181570001002004/
1.82E+14,15,0,0,0,12,0,12,39,105,144,27.08333333,72.91666667,tract_part,http://www.prisonersofthecensus.org/data/2010blocks/181570108002016/
1.82E+14,0,0,0,0,0,0,0,0,35,35,0,100,tract_part,http://www.prisonersofthecensus.org/data/2010blocks/181590204005020/
1.82E+14,0,0,0,0,2,0,1,3,15,18,16.66666667,83.33333333,tract_part,http://www.prisonersofthecensus.org/data/2010blocks/181619607004011/
1.82E+14,231,0,0,0,0,0,8,239,452,691,34.58755427,65.41244573,tract,http://www.prisonersofthecensus.org/data/2010blocks/181630035002010/
1.82E+14,73,0,0,0,6,0,11,90,227,317,28.39116719,71.60883281,tract,http://www.prisonersofthecensus.org/data/2010blocks/181670111005012/
1.82E+14,588,18,4,0,0,3,254,867,347,1214,71.41680395,28.58319605,institutionalized,http://www.prisonersofthecensus.org/data/2010blocks/181670112004100/
1.82E+14,994,47,12,0,0,6,368,1427,637,2064,69.1375969,30.8624031,institutionalized,http://www.prisonersofthecensus.org/data/2010blocks/181670112004106/
1.82E+14,2,0,1,0,0,1,4,8,101,109,7.339449541,92.66055046,tract_part,http://www.prisonersofthecensus.org/data/2010blocks/181691028003021/
1.82E+14,1,0,0,0,0,0,0,1,25,26,3.846153846,96.15384615,tract_part,http://www.prisonersofthecensus.org/data/2010blocks/181719510004085/
1.82E+14,3,1,0,0,1,1,2,8,57,65,12.30769231,87.69230769,tract_part,http://www.prisonersofthecensus.org/data/2010blocks/181730305003001/
1.82E+14,0,0,0,0,0,0,6,6,71,77,7.792207792,92.20779221,tract_part,http://www.prisonersofthecensus.org/data/2010blocks/181759676003027/
1.82E+14,47,0,0,0,3,0,3,53,243,296,17.90540541,82.09459459,tract,http://www.prisonersofthecensus.org/data/2010blocks/181770002001034/
1.82E+14,0,0,0,0,0,0,0,0,6,6,0,100,tract_part,http://www.prisonersofthecensus.org/data/2010blocks/181770008002002/
1.82E+14,4,0,0,0,0,0,2,6,98,104,5.769230769,94.23076923,tract_part,http://www.prisonersofthecensus.org/data/2010blocks/181790406001021/
1.82E+14,0,1,0,0,1,3,4,9,99,108,8.333333333,91.66666667,tract_part,http://www.prisonersofthecensus.org/data/2010blocks/181819585002199/
1.82E+14,1,1,0,0,1,0,1,4,55,59,6.779661017,93.22033898,tract_part,http://www.prisonersofthecensus.org/data/2010blocks/181830504001044/
1.82E+14,4,0,0,0,3,3,6,16,100,116,13.79310345,86.20689655,tract_part,http://www.prisonersofthecensus.org/data/2010blocks/181830505002012/
1.90E+14,0,0,0,0,0,0,0,0,1,1,0,100,tract_part,http://www.prisonersofthecensus.org/data/2010blocks/190019603002079/
1.90E+14,0,0,0,0,0,0,0,0,4,4,0,100,tract_part,http://www.prisonersofthecensus.org/data/2010blocks/190039502001074/
1.90E+14,13,0,0,1,0,1,3,18,43,61,29.50819672,70.49180328,tract_part,http://www.prisonersofthecensus.org/data/2010blocks/190059604002156/
1.90E+14,0,0,0,0,0,0,0,0,5,5,0,100,tract_part,http://www.prisonersofthecensus.org/data/2010blocks/190059603002046/
1.90E+14,1,0,0,0,0,0,0,1,14,15,6.666666667,93.33333333,tract_part,http://www.prisonersofthecensus.org/data/2010blocks/190079503002016/
1.90E+14,0,0,0,0,0,0,0,0,3,3,0,100,tract_part,http://www.prisonersofthecensus.org/data/2010blocks/190090702003062/
1.90E+14,1,0,0,0,0,0,0,1,9,10,10,90,tract_part,http://www.prisonersofthecensus.org/data/2010blocks/190119603002093/
1.90E+14,57,1,0,0,0,3,6,67,85,152,44.07894737,55.92105263,tract,http://www.prisonersofthecensus.org/data/2010blocks/190130001002047/
1.90E+14,1,0,0,0,0,0,0,1,7,8,12.5,87.5,tract_part,http://www.prisonersofthecensus.org/data/2010blocks/190150204002018/
1.90E+14,5,0,1,0,1,0,3,10,18,28,35.71428571,64.28571429,tract_part,http://www.prisonersofthecensus.org/data/2010blocks/190170041001029/
1.90E+14,1,0,0,0,0,0,1,2,2,4,50,50,tract_part,http://www.prisonersofthecensus.org/data/2010blocks/190199505003024/
1.90E+14,3,0,2,0,1,0,6,12,9,21,57.14285714,42.85714286,tract_part,http://www.prisonersofthecensus.org/data/2010blocks/190219604001039/
1.90E+14,0,0,0,0,0,0,0,0,6,6,0,100,tract_part,http://www.prisonersofthecensus.org/data/2010blocks/190230703001126/
1.90E+14,0,0,0,0,0,0,1,1,10,11,9.090909091,90.90909091,tract_part,http://www.prisonersofthecensus.org/data/2010blocks/190279604003002/
1.90E+14,1,0,0,0,0,0,0,1,13,14,7.142857143,92.85714286,tract_part,http://www.prisonersofthecensus.org/data/2010blocks/190291905002159/
1.90E+14,4,0,1,0,0,0,2,7,16,23,30.43478261,69.56521739,tract_part,http://www.prisonersofthecensus.org/data/2010blocks/190314503003065/
1.90E+14,7,0,0,0,0,1,0,8,37,45,17.77777778,82.22222222,tract_part,http://www.prisonersofthecensus.org/data/2010blocks/190339507002009/
1.90E+14,4,2,0,0,0,0,1,7,40,47,14.89361702,85.10638298,tract_part,http://www.prisonersofthecensus.org/data/2010blocks/190339503003023/
1.90E+14,0,0,0,0,0,0,0,0,6,6,0,100,tract_part,http://www.prisonersofthecensus.org/data/2010blocks/190350801005043/
1.90E+14,4,0,0,0,0,0,1,5,11,16,31.25,68.75,tract_part,http://www.prisonersofthecensus.org/data/2010blocks/190399601001011/
1.90E+14,0,0,0,0,0,0,1,1,11,12,8.333333333,91.66666667,tract_part,http://www.prisonersofthecensus.org/data/2010blocks/190410803005015/
1.90E+14,0,0,0,0,0,0,0,0,9,9,0,100,tract_part,http://www.prisonersofthecensus.org/data/2010blocks/190430703002040/
1.90E+14,6,0,0,0,0,0,0,6,26,32,18.75,81.25,tract,http://www.prisonersofthecensus.org/data/2010blocks/190450001001013/
1.90E+14,0,0,0,0,4,0,8,12,1,13,92.30769231,7.692307692,tract_part,http://www.prisonersofthecensus.org/data/2010blocks/190470704005018/
1.90E+14,1,1,0,0,3,1,8,14,23,37,37.83783784,62.16216216,tract_part,http://www.prisonersofthecensus.org/data/2010blocks/190490507001046/
1.91E+14,0,0,0,0,0,0,0,0,1,1,0,100,tract_part,http://www.prisonersofthecensus.org/data/2010blocks/190539603001100/
1.91E+14,20,0,0,0,0,0,4,24,39,63,38.0952381,61.9047619,tract,http://www.prisonersofthecensus.org/data/2010blocks/190570004002003/
1.91E+14,24,0,1,0,0,0,3,28,41,69,40.57971014,59.42028986,tract_part,http://www.prisonersofthecensus.org/data/2010blocks/190570007002011/
1.91E+14,0,0,0,0,0,0,1,1,9,10,10,90,tract_part,http://www.prisonersofthecensus.org/data/2010blocks/190594505004046/
1.91E+14,15,1,0,0,1,2,4,23,68,91,25.27472527,74.72527473,institutionalized,http://www.prisonersofthecensus.org/data/2010blocks/190610001001050/
1.91E+14,65,0,0,1,0,0,8,74,85,159,46.5408805,53.4591195,institutionalized,http://www.prisonersofthecensus.org/data/2010blocks/190610001002001/
1.91E+14,1,0,0,0,0,0,1,2,5,7,28.57142857,71.42857143,tract_part,http://www.prisonersofthecensus.org/data/2010blocks/190630704003033/
1.91E+14,5,1,0,0,4,0,4,14,35,49,28.57142857,71.42857143,institutionalized,http://www.prisonersofthecensus.org/data/2010blocks/190650801001029/
1.91E+14,7,0,0,0,0,0,1,8,18,26,30.76923077,69.23076923,institutionalized,http://www.prisonersofthecensus.org/data/2010blocks/190650801002061/
1.91E+14,0,0,0,0,0,0,0,0,7,7,0,100,tract_part,http://www.prisonersofthecensus.org/data/2010blocks/190719702003076/
1.91E+14,0,0,0,0,0,0,1,1,2,3,33.33333333,66.66666667,tract_part,http://www.prisonersofthecensus.org/data/2010blocks/190730802002058/
1.91E+14,0,0,0,0,0,0,1,1,6,7,14.28571429,85.71428571,tract_part,http://www.prisonersofthecensus.org/data/2010blocks/190779503002082/
1.91E+14,0,0,0,0,0,0,1,1,12,13,7.692307692,92.30769231,tract_part,http://www.prisonersofthecensus.org/data/2010blocks/190799603003022/
1.91E+14,0,0,0,0,0,0,0,0,3,3,0,100,tract_part,http://www.prisonersofthecensus.org/data/2010blocks/190812701002015/
1.91E+14,6,0,0,0,0,5,35,46,16,62,74.19354839,25.80645161,tract_part,http://www.prisonersofthecensus.org/data/2010blocks/190834806002013/
1.91E+14,0,0,0,0,0,0,0,0,7,7,0,100,tract_part,http://www.prisonersofthecensus.org/data/2010blocks/190852903002034/
1.91E+14,0,1,0,0,1,0,2,4,4,8,50,50,institutionalized,http://www.prisonersofthecensus.org/data/2010blocks/190879704001011/
1.91E+14,119,23,7,3,33,27,91,303,654,957,31.66144201,68.33855799,institutionalized,http://www.prisonersofthecensus.org/data/2010blocks/190879704002044/
1.91E+14,2,0,0,0,0,0,0,2,7,9,22.22222222,77.77777778,tract_part,http://www.prisonersofthecensus.org/data/2010blocks/190899601004026/
1.91E+14,0,0,0,0,0,0,0,0,1,1,0,100,tract_part,http://www.prisonersofthecensus.org/data/2010blocks/190919703001021/
1.91E+14,5,1,0,0,1,1,4,12,21,33,36.36363636,63.63636364,tract_part,http://www.prisonersofthecensus.org/data/2010blocks/190959602003080/
1.91E+14,0,0,0,0,0,0,0,0,5,5,0,100,tract_part,http://www.prisonersofthecensus.org/data/2010blocks/190979505003013/
1.91E+14,3,0,1,0,0,0,0,4,38,42,9.523809524,90.47619048,tract_part,http://www.prisonersofthecensus.org/data/2010blocks/190990409003013/
1.91E+14,295,10,8,2,0,1,45,361,795,1156,31.2283737,68.7716263,tract_part,http://www.prisonersofthecensus.org/data/2010blocks/190990408001074/
1.91E+14,1,0,0,0,0,0,0,1,8,9,11.11111111,88.88888889,tract_part,http://www.prisonersofthecensus.org/data/2010blocks/191010903003077/
1.91E+14,158,18,5,1,10,6,49,247,695,942,26.22080679,73.77919321,remaining,http://www.prisonersofthecensus.org/data/2010blocks/191030003011002/
1.91E+14,16,0,0,0,0,0,0,16,37,53,30.18867925,69.81132075,institutionalized,http://www.prisonersofthecensus.org/data/2010blocks/191030003012019/
1.91E+14,36,0,1,0,0,0,7,44,28,72,61.11111111,38.88888889,tract,http://www.prisonersofthecensus.org/data/2010blocks/191030021001032/
1.91E+14,338,16,14,2,1,1,62,434,612,1046,41.49139579,58.50860421,institutionalized,http://www.prisonersofthecensus.org/data/2010blocks/191050703002020/
1.91E+14,0,0,0,0,0,0,0,0,7,7,0,100,institutionalized,http://www.prisonersofthecensus.org/data/2010blocks/191050703002031/
1.91E+14,0,0,0,0,0,0,0,0,2,2,0,100,tract_part,http://www.prisonersofthecensus.org/data/2010blocks/191070803003033/
1.91E+14,0,0,0,0,0,0,1,1,11,12,8.333333333,91.66666667,tract_part,http://www.prisonersofthecensus.org/data/2010blocks/191099504002014/
1.91E+14,3,0,0,0,0,0,0,3,23,26,11.53846154,88.46153846,tract_part,http://www.prisonersofthecensus.org/data/2010blocks/191114902003088/
1.91E+14,16,0,0,0,0,0,1,17,36,53,32.0754717,67.9245283,tract_part,http://www.prisonersofthecensus.org/data/2010blocks/191114905001036/
1.91E+14,329,13,1,0,0,2,62,407,595,1002,40.61876248,59.38123752,tract_part,http://www.prisonersofthecensus.org/data/2010blocks/191114902002025/
1.91E+14,87,4,0,0,9,6,17,123,195,318,38.67924528,61.32075472,tract,http://www.prisonersofthecensus.org/data/2010blocks/191130022001059/
1.91E+14,37,4,0,0,0,1,3,45,126,171,26.31578947,73.68421053,tract,http://www.prisonersofthecensus.org/data/2010blocks/191130029004016/
1.91E+14,0,0,0,0,0,0,2,2,1,3,66.66666667,33.33333333,tract_part,http://www.prisonersofthecensus.org/data/2010blocks/191154501003144/
1.91E+14,0,0,0,0,0,0,2,2,15,17,11.76470588,88.23529412,tract_part,http://www.prisonersofthecensus.org/data/2010blocks/191199502004032/
1.91E+14,1,0,0,0,0,0,0,1,7,8,12.5,87.5,tract_part,http://www.prisonersofthecensus.org/data/2010blocks/191210602001009/
1.91E+14,1,0,0,0,0,0,0,1,15,16,6.25,93.75,tract_part,http://www.prisonersofthecensus.org/data/2010blocks/191239506001020/
1.91E+14,1,0,0,0,0,0,0,1,23,24,4.166666667,95.83333333,tract_part,http://www.prisonersofthecensus.org/data/2010blocks/191250304021044/
1.91E+14,4,2,0,0,0,0,5,11,39,50,22,78,tract_part,http://www.prisonersofthecensus.org/data/2010blocks/191279510002004/
1.91E+14,36,0,2,0,1,0,11,50,91,141,35.46099291,64.53900709,tract_part,http://www.prisonersofthecensus.org/data/2010blocks/191279503001045/
1.91E+14,0,0,0,0,0,0,1,1,7,8,12.5,87.5,institutionalized,http://www.prisonersofthecensus.org/data/2010blocks/191290403021054/
1.91E+14,10,2,2,0,1,3,2,20,281,301,6.644518272,93.35548173,institutionalized,http://www.prisonersofthecensus.org/data/2010blocks/191290403023087/
1.91E+14,2,0,0,0,0,0,5,7,14,21,33.33333333,66.66666667,tract_part,http://www.prisonersofthecensus.org/data/2010blocks/191315603003006/
1.91E+14,0,0,0,0,0,0,0,0,3,3,0,100,tract_part,http://www.prisonersofthecensus.org/data/2010blocks/191339603002034/
1.91E+14,0,0,0,0,0,0,0,0,4,4,0,100,tract_part,http://www.prisonersofthecensus.org/data/2010blocks/191350702003018/
1.91E+14,2,0,0,0,2,0,8,12,20,32,37.5,62.5,tract_part,http://www.prisonersofthecensus.org/data/2010blocks/191390507003028/
1.91E+14,29,1,0,0,8,2,20,60,32,92,65.2173913,34.7826087,tract,http://www.prisonersofthecensus.org/data/2010blocks/191390509002013/
1.91E+14,2,3,0,0,0,0,4,9,20,29,31.03448276,68.96551724,tract_part,http://www.prisonersofthecensus.org/data/2010blocks/191414902005086/
1.91E+14,0,0,0,0,0,1,1,2,3,5,40,60,tract_part,http://www.prisonersofthecensus.org/data/2010blocks/191434601002069/
1.91E+14,0,0,0,0,0,1,1,2,6,8,25,75,institutionalized,http://www.prisonersofthecensus.org/data/2010blocks/191454904001058/
1.91E+14,2,0,0,2,0,0,2,6,48,54,11.11111111,88.88888889,remaining,http://www.prisonersofthecensus.org/data/2010blocks/191454904003008/
1.91E+14,203,35,7,0,33,21,85,384,636,1020,37.64705882,62.35294118,institutionalized,http://www.prisonersofthecensus.org/data/2010blocks/191454904003009/
1.91E+14,0,0,0,0,0,0,0,0,4,4,0,100,tract_part,http://www.prisonersofthecensus.org/data/2010blocks/191479603004083/
1.92E+14,0,0,0,0,0,0,0,0,5,5,0,100,tract_part,http://www.prisonersofthecensus.org/data/2010blocks/191517802002033/
1.92E+14,124,16,1,1,0,1,20,163,386,549,29.69034608,70.30965392,tract_part,http://www.prisonersofthecensus.org/data/2010blocks/191530107022043/
1.92E+14,7,0,0,0,1,1,2,11,21,32,34.375,65.625,institutionalized,http://www.prisonersofthecensus.org/data/2010blocks/191530047021010/
1.92E+14,47,0,3,0,2,8,9,69,123,192,35.9375,64.0625,institutionalized,http://www.prisonersofthecensus.org/data/2010blocks/191530047021018/
1.92E+14,10,1,1,0,0,2,2,16,42,58,27.5862069,72.4137931,tract,http://www.prisonersofthecensus.org/data/2010blocks/191530007013004/
1.92E+14,8,0,0,0,0,0,0,8,6,14,57.14285714,42.85714286,institutionalized,http://www.prisonersofthecensus.org/data/2010blocks/191530049001026/
1.92E+14,3,0,0,0,0,1,1,5,18,23,21.73913043,78.26086957,institutionalized,http://www.prisonersofthecensus.org/data/2010blocks/191530049002003/
1.92E+14,265,3,14,0,0,1,175,458,566,1024,44.7265625,55.2734375,tract_part,http://www.prisonersofthecensus.org/data/2010blocks/191530105003012/
1.92E+14,2,1,0,0,0,0,0,3,14,17,17.64705882,82.35294118,institutionalized,http://www.prisonersofthecensus.org/data/2010blocks/191550307004021/
1.92E+14,5,1,0,0,0,2,2,10,61,71,14.08450704,85.91549296,institutionalized,http://www.prisonersofthecensus.org/data/2010blocks/191550307004022/
1.92E+14,25,6,0,0,0,0,6,37,35,72,51.38888889,48.61111111,tract,http://www.prisonersofthecensus.org/data/2010blocks/191550310003016/
1.92E+14,21,4,1,0,3,13,47,89,121,210,42.38095238,57.61904762,tract_part,http://www.prisonersofthecensus.org/data/2010blocks/191550318003047/
1.92E+14,0,1,0,0,0,0,1,2,8,10,20,80,tract_part,http://www.prisonersofthecensus.org/data/2010blocks/191573705002180/
1.92E+14,0,0,0,0,0,0,0,0,1,1,0,100,tract_part,http://www.prisonersofthecensus.org/data/2010blocks/191599502002035/
1.92E+14,0,0,0,0,0,0,0,0,7,7,0,100,tract_part,http://www.prisonersofthecensus.org/data/2010blocks/191610804002063/
1.92E+14,23,1,0,0,2,3,6,35,46,81,43.20987654,56.79012346,tract,http://www.prisonersofthecensus.org/data/2010blocks/191630106002046/
1.92E+14,111,3,2,0,8,6,31,161,127,288,55.90277778,44.09722222,institutionalized,http://www.prisonersofthecensus.org/data/2010blocks/191630109001005/
1.92E+14,13,0,1,0,2,5,5,26,38,64,40.625,59.375,institutionalized,http://www.prisonersofthecensus.org/data/2010blocks/191630109002013/
1.92E+14,0,0,0,0,0,0,2,2,5,7,28.57142857,71.42857143,tract_part,http://www.prisonersofthecensus.org/data/2010blocks/191659604002052/
1.92E+14,1,0,0,0,0,2,4,7,23,30,23.33333333,76.66666667,tract_part,http://www.prisonersofthecensus.org/data/2010blocks/191670701001047/
1.92E+14,2,0,0,0,3,2,8,15,19,34,44.11764706,55.88235294,tract_part,http://www.prisonersofthecensus.org/data/2010blocks/191670702003113/
1.92E+14,22,1,2,0,0,1,9,35,54,89,39.3258427,60.6741573,tract_part,http://www.prisonersofthecensus.org/data/2010blocks/191690103001031/
1.92E+14,7,0,0,0,0,0,0,7,35,42,16.66666667,83.33333333,tract,http://www.prisonersofthecensus.org/data/2010blocks/191690010002015/
1.92E+14,0,4,0,0,0,0,2,6,8,14,42.85714286,57.14285714,tract_part,http://www.prisonersofthecensus.org/data/2010blocks/191712904002060/
1.92E+14,0,0,0,0,0,0,1,1,3,4,25,75,tract_part,http://www.prisonersofthecensus.org/data/2010blocks/191731802002068/
1.92E+14,0,0,1,0,0,0,0,1,8,9,11.11111111,88.88888889,tract_part,http://www.prisonersofthecensus.org/data/2010blocks/191751902005033/
1.92E+14,0,0,0,0,0,0,0,0,1,1,0,100,tract_part,http://www.prisonersofthecensus.org/data/2010blocks/191779501004055/
1.92E+14,4,0,0,0,1,1,1,7,51,58,12.06896552,87.93103448,tract_part,http://www.prisonersofthecensus.org/data/2010blocks/191799603003043/
1.92E+14,3,1,0,0,1,1,2,8,42,50,16,84,tract_part,http://www.prisonersofthecensus.org/data/2010blocks/191799606001010/
1.92E+14,0,0,0,0,0,0,0,0,17,17,0,100,tract_part,http://www.prisonersofthecensus.org/data/2010blocks/191810210001016/
1.92E+14,7,0,0,0,0,0,2,9,17,26,34.61538462,65.38461538,tract_part,http://www.prisonersofthecensus.org/data/2010blocks/191839602004050/
1.92E+14,0,0,0,0,0,0,0,0,10,10,0,100,tract_part,http://www.prisonersofthecensus.org/data/2010blocks/191850701002064/
1.92E+14,9,1,0,0,0,0,1,11,22,33,33.33333333,66.66666667,institutionalized,http://www.prisonersofthecensus.org/data/2010blocks/191870007002014/
1.92E+14,3,1,0,0,0,0,2,6,53,59,10.16949153,89.83050847,institutionalized,http://www.prisonersofthecensus.org/data/2010blocks/191870007002032/
1.92E+14,353,34,12,0,0,1,85,485,676,1161,41.77433247,58.22566753,tract_part,http://www.prisonersofthecensus.org/data/2010blocks/191870009003124/
1.92E+14,0,0,0,0,0,0,2,2,4,6,33.33333333,66.66666667,tract_part,http://www.prisonersofthecensus.org/data/2010blocks/191896803005026/
1.92E+14,2,0,0,1,0,0,0,3,10,13,23.07692308,76.92307692,tract_part,http://www.prisonersofthecensus.org/data/2010blocks/191919502001004/
1.92E+14,18,24,1,0,9,10,18,80,81,161,49.68944099,50.31055901,institutionalized,http://www.prisonersofthecensus.org/data/2010blocks/191930036002027/
1.92E+14,10,10,0,0,0,0,4,24,28,52,46.15384615,53.84615385,institutionalized,http://www.prisonersofthecensus.org/data/2010blocks/191930036002040/
1.92E+14,0,0,1,0,0,0,0,1,4,5,20,80,tract_part,http://www.prisonersofthecensus.org/data/2010blocks/191930033002072/
1.92E+14,0,0,0,0,0,0,0,0,5,5,0,100,tract_part,http://www.prisonersofthecensus.org/data/2010blocks/191956901002049/
1.92E+14,1,0,0,0,0,0,0,1,8,9,11.11111111,88.88888889,tract_part,http://www.prisonersofthecensus.org/data/2010blocks/191976803001169/
2.00E+14,1,1,0,0,0,2,2,6,24,30,20,80,tract_part,http://www.prisonersofthecensus.org/data/2010blocks/200019529001034/
2.00E+14,0,0,0,0,0,0,0,0,19,19,0,100,tract_part,http://www.prisonersofthecensus.org/data/2010blocks/200039536004101/
2.00E+14,7,1,0,0,0,2,1,11,25,36,30.55555556,69.44444444,tract,http://www.prisonersofthecensus.org/data/2010blocks/200050819004020/
2.00E+14,3,0,0,0,12,3,14,32,46,78,41.02564103,58.97435897,tract_part,http://www.prisonersofthecensus.org/data/2010blocks/200099717001021/
2.00E+14,6,2,0,0,0,0,0,8,34,42,19.04761905,80.95238095,tract_part,http://www.prisonersofthecensus.org/data/2010blocks/200119560001053/
2.00E+14,0,5,0,0,0,0,0,5,9,14,35.71428571,64.28571429,tract_part,http://www.prisonersofthecensus.org/data/2010blocks/200134807004027/
2.00E+14,25,1,0,0,0,1,111,138,0,138,100,0,tract_part,http://www.prisonersofthecensus.org/data/2010blocks/200150202013168/
2.00E+14,462,21,5,0,0,1,161,650,620,1270,51.18110236,48.81889764,tract_part,http://www.prisonersofthecensus.org/data/2010blocks/200150201002168/
2.00E+14,28,0,0,0,4,8,44,84,31,115,73.04347826,26.95652174,tract_part,http://www.prisonersofthecensus.org/data/2010blocks/200179606003009/
2.00E+14,0,0,0,0,0,2,0,2,12,14,14.28571429,85.71428571,tract_part,http://www.prisonersofthecensus.org/data/2010blocks/200274582003044/
2.00E+14,0,0,0,0,0,0,0,0,3,3,0,100,tract_part,http://www.prisonersofthecensus.org/data/2010blocks/200274581004082/
2.00E+14,0,0,0,0,0,0,2,2,12,14,14.28571429,85.71428571,tract_part,http://www.prisonersofthecensus.org/data/2010blocks/200299773004060/
2.00E+14,0,0,0,0,0,0,0,0,6,6,0,100,tract_part,http://www.prisonersofthecensus.org/data/2010blocks/200319663002010/
2.00E+14,1,0,0,0,0,0,0,1,1,2,50,50,tract_part,http://www.prisonersofthecensus.org/data/2010blocks/200354938004025/
2.00E+14,76,6,2,0,0,0,11,95,152,247,38.46153846,61.53846154,institutionalized,http://www.prisonersofthecensus.org/data/2010blocks/200354935003043/
2.00E+14,77,8,2,0,0,0,19,106,204,310,34.19354839,65.80645161,institutionalized,http://www.prisonersofthecensus.org/data/2010blocks/200354935003044/
2.00E+14,8,1,1,0,0,0,20,30,76,106,28.30188679,71.69811321,tract_part,http://www.prisonersofthecensus.org/data/2010blocks/200354936001002/
2.00E+14,4,0,0,0,0,0,0,4,9,13,30.76923077,69.23076923,institutionalized,http://www.prisonersofthecensus.org/data/2010blocks/200379568001023/
2.00E+14,8,0,0,0,0,0,1,9,71,80,11.25,88.75,institutionalized,http://www.prisonersofthecensus.org/data/2010blocks/200379568001024/
2.00E+14,0,0,0,0,0,1,1,2,1,3,66.66666667,33.33333333,tract_part,http://www.prisonersofthecensus.org/data/2010blocks/200399512001070/
2.00E+14,1,3,0,0,0,1,3,8,32,40,20,80,tract_part,http://www.prisonersofthecensus.org/data/2010blocks/200410844003086/
2.00E+14,2,1,0,0,0,1,2,6,5,11,54.54545455,45.45454545,tract_part,http://www.prisonersofthecensus.org/data/2010blocks/200430202002058/
2.00E+14,36,13,1,0,0,0,7,57,85,142,40.14084507,59.85915493,tract_part,http://www.prisonersofthecensus.org/data/2010blocks/200450010022013/
2.00E+14,0,0,0,0,0,1,1,2,4,6,33.33333333,66.66666667,tract_part,http://www.prisonersofthecensus.org/data/2010blocks/200479697001057/
2.01E+14,0,0,0,0,0,0,0,0,6,6,0,100,tract_part,http://www.prisonersofthecensus.org/data/2010blocks/200499651003124/
2.01E+14,6,1,0,0,6,0,6,19,22,41,46.34146341,53.65853659,tract_part,http://www.prisonersofthecensus.org/data/2010blocks/200510728003019/
2.01E+14,1,0,0,0,0,0,4,5,11,16,31.25,68.75,institutionalized,http://www.prisonersofthecensus.org/data/2010blocks/200530867002030/
2.01E+14,285,11,4,0,0,3,100,403,421,824,48.90776699,51.09223301,institutionalized,http://www.prisonersofthecensus.org/data/2010blocks/200530867004006/
2.01E+14,16,0,0,0,0,0,79,95,40,135,70.37037037,29.62962963,tract_part,http://www.prisonersofthecensus.org/data/2010blocks/200559606003021/
2.01E+14,5,0,2,0,0,0,48,55,46,101,54.45544554,45.54455446,tract_part,http://www.prisonersofthecensus.org/data/2010blocks/200579621012007/
2.01E+14,1,0,0,0,0,0,0,1,39,40,2.5,97.5,tract_part,http://www.prisonersofthecensus.org/data/2010blocks/200599544002024/
2.01E+14,35,2,0,0,0,10,14,61,32,93,65.59139785,34.40860215,tract_part,http://www.prisonersofthecensus.org/data/2010blocks/200610001003050/
2.01E+14,0,0,0,0,0,0,11,11,11,22,50,50,tract_part,http://www.prisonersofthecensus.org/data/2010blocks/200679637003049/
2.01E+14,0,2,0,0,0,0,7,9,17,26,34.61538462,65.38461538,tract_part,http://www.prisonersofthecensus.org/data/2010blocks/200739657001064/
2.01E+14,18,0,2,0,0,1,4,25,78,103,24.27184466,75.72815534,tract_part,http://www.prisonersofthecensus.org/data/2010blocks/200790301003031/
2.01E+14,0,0,0,0,0,0,3,3,0,3,100,0,tract_part,http://www.prisonersofthecensus.org/data/2010blocks/200814631002019/
2.01E+14,5,4,0,0,12,0,12,33,30,63,52.38095238,47.61904762,tract_part,http://www.prisonersofthecensus.org/data/2010blocks/200850827002015/
2.01E+14,0,1,0,0,1,1,1,4,13,17,23.52941176,76.47058824,tract_part,http://www.prisonersofthecensus.org/data/2010blocks/200870203001153/
2.01E+14,0,0,0,0,0,0,0,0,2,2,0,100,tract_part,http://www.prisonersofthecensus.org/data/2010blocks/200895762002135/
2.01E+14,48,6,3,1,8,8,25,99,170,269,36.80297398,63.19702602,institutionalized,http://www.prisonersofthecensus.org/data/2010blocks/200910537112062/
2.01E+14,184,4,4,0,23,9,70,294,545,839,35.04171633,64.95828367,institutionalized,http://www.prisonersofthecensus.org/data/2010blocks/200910537112067/
2.01E+14,0,0,0,0,0,0,0,0,2,2,0,100,tract,http://www.prisonersofthecensus.org/data/2010blocks/200910524171018/
2.01E+14,0,0,0,0,0,0,3,3,3,6,50,50,tract_part,http://www.prisonersofthecensus.org/data/2010blocks/200939591002069/
2.01E+14,0,0,0,0,0,0,0,0,6,6,0,100,tract_part,http://www.prisonersofthecensus.org/data/2010blocks/200959612004099/
2.01E+14,12,0,0,0,0,4,4,20,29,49,40.81632653,59.18367347,tract_part,http://www.prisonersofthecensus.org/data/2010blocks/200999507002060/
2.01E+14,0,0,0,0,0,0,0,0,3,3,0,100,tract_part,http://www.prisonersofthecensus.org/data/2010blocks/201019566003096/
2.01E+14,907,32,27,0,0,0,160,1126,1220,2346,47.99658994,52.00341006,tract_part,http://www.prisonersofthecensus.org/data/2010blocks/201030711022050/
2.01E+14,332,3,10,0,0,0,203,548,251,799,68.58573217,31.41426783,tract_part,http://www.prisonersofthecensus.org/data/2010blocks/201030705004041/
2.01E+14,125,0,12,3,0,1,53,194,249,443,43.79232506,56.20767494,institutionalized,http://www.prisonersofthecensus.org/data/2010blocks/201039819001001/
2.01E+14,722,104,16,1,219,80,546,1688,656,2344,72.01365188,27.98634812,institutionalized,http://www.prisonersofthecensus.org/data/2010blocks/201039819002026/
2.01E+14,0,0,0,0,0,0,0,0,1,1,0,100,tract_part,http://www.prisonersofthecensus.org/data/2010blocks/201050861004047/
2.01E+14,2,0,0,0,3,0,3,8,23,31,25.80645161,74.19354839,tract_part,http://www.prisonersofthecensus.org/data/2010blocks/201079552002132/
2.01E+14,14,2,0,0,9,5,32,62,61,123,50.40650407,49.59349593,tract_part,http://www.prisonersofthecensus.org/data/2010blocks/201110005002026/
2.01E+14,0,0,0,0,0,0,0,0,9,9,0,100,tract_part,http://www.prisonersofthecensus.org/data/2010blocks/201154897003227/
2.01E+14,0,0,0,0,1,1,1,3,16,19,15.78947368,84.21052632,tract_part,http://www.prisonersofthecensus.org/data/2010blocks/201170605103050/
2.01E+14,13,0,0,0,0,0,10,23,26,49,46.93877551,53.06122449,tract_part,http://www.prisonersofthecensus.org/data/2010blocks/201199667001177/
2.01E+14,0,0,0,0,0,0,0,0,12,12,0,100,tract_part,http://www.prisonersofthecensus.org/data/2010blocks/201231766001165/
2.01E+14,30,0,0,0,5,0,9,44,87,131,33.58778626,66.41221374,tract_part,http://www.prisonersofthecensus.org/data/2010blocks/201259504002039/
2.01E+14,0,0,0,0,0,0,0,0,4,4,0,100,tract_part,http://www.prisonersofthecensus.org/data/2010blocks/201279637003028/
2.01E+14,1,0,0,0,0,0,2,3,6,9,33.33333333,66.66666667,tract_part,http://www.prisonersofthecensus.org/data/2010blocks/201299646003127/
2.01E+14,0,0,0,0,0,0,0,0,6,6,0,100,tract_part,http://www.prisonersofthecensus.org/data/2010blocks/201314802002162/
2.01E+14,2,0,0,0,0,0,1,3,28,31,9.677419355,90.32258065,tract_part,http://www.prisonersofthecensus.org/data/2010blocks/201339516004118/
2.01E+14,0,0,0,0,0,0,0,0,3,3,0,100,tract_part,http://www.prisonersofthecensus.org/data/2010blocks/201359562002078/
2.01E+14,151,3,18,0,1,0,101,274,458,732,37.43169399,62.56830601,tract_part,http://www.prisonersofthecensus.org/data/2010blocks/201379517001207/
2.01E+14,0,0,0,0,0,0,0,0,4,4,0,100,tract_part,http://www.prisonersofthecensus.org/data/2010blocks/201379517004065/
2.01E+14,0,0,0,0,0,1,1,2,15,17,11.76470588,88.23529412,tract_part,http://www.prisonersofthecensus.org/data/2010blocks/201390105002072/
2.01E+14,0,0,0,0,0,0,0,0,5,5,0,100,tract_part,http://www.prisonersofthecensus.org/data/2010blocks/201414741004021/
2.01E+14,15,0,0,0,2,1,3,21,21,42,50,50,tract_part,http://www.prisonersofthecensus.org/data/2010blocks/201430857003017/
2.01E+14,0,0,0,0,0,0,0,0,8,8,0,100,tract_part,http://www.prisonersofthecensus.org/data/2010blocks/201459702003073/
2.01E+14,108,8,1,0,1,0,33,151,221,372,40.59139785,59.40860215,tract_part,http://www.prisonersofthecensus.org/data/2010blocks/201459702004048/
2.01E+14,1,0,1,0,1,0,3,6,6,12,50,50,tract_part,http://www.prisonersofthecensus.org/data/2010blocks/201474753001144/
2.01E+14,2,0,1,0,0,0,0,3,10,13,23.07692308,76.92307692,tract_part,http://www.prisonersofthecensus.org/data/2010blocks/201490004004127/
2.02E+14,0,0,0,0,0,0,1,1,12,13,7.692307692,92.30769231,tract_part,http://www.prisonersofthecensus.org/data/2010blocks/201519688002015/
2.02E+14,16,0,0,0,0,0,6,22,52,74,29.72972973,70.27027027,remaining,http://www.prisonersofthecensus.org/data/2010blocks/201550006002025/
2.02E+14,12,0,0,0,0,0,8,20,43,63,31.74603175,68.25396825,institutionalized,http://www.prisonersofthecensus.org/data/2010blocks/201550006002030/
2.02E+14,415,18,8,0,0,3,114,558,526,1084,51.47601476,48.52398524,institutionalized,http://www.prisonersofthecensus.org/data/2010blocks/201550008004005/
2.02E+14,46,1,0,0,1,1,14,63,178,241,26.14107884,73.85892116,institutionalized,http://www.prisonersofthecensus.org/data/2010blocks/201550008004007/
2.02E+14,139,7,4,0,1,1,54,206,252,458,44.97816594,55.02183406,tract_part,http://www.prisonersofthecensus.org/data/2010blocks/201550011003084/
2.02E+14,0,0,6,0,0,0,0,6,0,6,100,0,tract_part,http://www.prisonersofthecensus.org/data/2010blocks/201550013001066/
2.02E+14,2,0,0,0,2,1,10,15,35,50,30,70,tract_part,http://www.prisonersofthecensus.org/data/2010blocks/201599672003082/
2.02E+14,28,1,0,0,2,9,12,52,47,99,52.52525253,47.47474747,tract_part,http://www.prisonersofthecensus.org/data/2010blocks/201610006005020/
2.02E+14,0,0,0,0,0,0,0,0,11,11,0,100,tract_part,http://www.prisonersofthecensus.org/data/2010blocks/201639746002288/
2.02E+14,0,0,0,0,0,0,1,1,10,11,9.090909091,90.90909091,tract_part,http://www.prisonersofthecensus.org/data/2010blocks/201679738004042/
2.02E+14,25,1,4,0,0,0,12,42,116,158,26.58227848,73.41772152,tract_part,http://www.prisonersofthecensus.org/data/2010blocks/201690003001009/
2.02E+14,1,0,0,0,0,1,3,5,15,20,25,75,tract_part,http://www.prisonersofthecensus.org/data/2010blocks/201719571005080/
2.02E+14,87,3,1,0,0,0,21,112,141,253,44.2687747,55.7312253,tract,http://www.prisonersofthecensus.org/data/2010blocks/201730026001015/
2.02E+14,57,0,3,1,0,0,11,72,59,131,54.96183206,45.03816794,institutionalized,http://www.prisonersofthecensus.org/data/2010blocks/201730043001016/
2.02E+14,388,31,13,1,28,44,155,660,465,1125,58.66666667,41.33333333,institutionalized,http://www.prisonersofthecensus.org/data/2010blocks/201730043001022/
2.02E+14,35,2,0,0,1,0,17,55,89,144,38.19444444,61.80555556,tract,http://www.prisonersofthecensus.org/data/2010blocks/201730051001000/
2.02E+14,0,0,0,0,0,0,0,0,3,3,0,100,tract,http://www.prisonersofthecensus.org/data/2010blocks/201730060005024/
2.02E+14,0,0,0,0,0,0,1,1,1,2,50,50,tract,http://www.prisonersofthecensus.org/data/2010blocks/201730071023001/
2.02E+14,13,0,1,0,0,1,83,98,31,129,75.96899225,24.03100775,tract_part,http://www.prisonersofthecensus.org/data/2010blocks/201759660002062/
2.02E+14,172,13,3,0,0,0,47,235,325,560,41.96428571,58.03571429,tract_part,http://www.prisonersofthecensus.org/data/2010blocks/201770031001038/
2.02E+14,141,6,0,0,1,15,22,185,230,415,44.57831325,55.42168675,institutionalized,http://www.prisonersofthecensus.org/data/2010blocks/201770040002048/
2.02E+14,12,2,0,0,0,1,5,20,29,49,40.81632653,59.18367347,institutionalized,http://www.prisonersofthecensus.org/data/2010blocks/201770040002049/
2.02E+14,0,0,0,0,0,0,0,0,1,1,0,100,tract_part,http://www.prisonersofthecensus.org/data/2010blocks/201834758002089/
2.02E+14,5,0,0,0,0,0,8,13,12,25,52,48,tract_part,http://www.prisonersofthecensus.org/data/2010blocks/201879641002066/
2.02E+14,2,0,0,0,1,0,5,8,6,14,57.14285714,42.85714286,tract_part,http://www.prisonersofthecensus.org/data/2010blocks/201899652003023/
2.02E+14,26,1,0,0,0,0,16,43,66,109,39.44954128,60.55045872,tract_part,http://www.prisonersofthecensus.org/data/2010blocks/201919625002003/
2.02E+14,1,0,0,0,0,0,1,2,7,9,22.22222222,77.77777778,tract_part,http://www.prisonersofthecensus.org/data/2010blocks/201939531001123/
2.02E+14,1,2,0,0,0,1,2,6,37,43,13.95348837,86.04651163,tract_part,http://www.prisonersofthecensus.org/data/2010blocks/202050973001046/
2.02E+14,0,0,0,0,0,0,0,0,4,4,0,100,tract_part,http://www.prisonersofthecensus.org/data/2010blocks/202070967001162/
2.02E+14,139,3,2,0,7,6,37,194,99,293,66.2116041,33.7883959,tract,http://www.prisonersofthecensus.org/data/2010blocks/202090420011000/
2.10E+14,17,0,0,0,0,0,3,20,92,112,17.85714286,82.14285714,tract_part,http://www.prisonersofthecensus.org/data/2010blocks/210019704023075/
2.10E+14,6,0,0,0,0,0,6,12,67,79,15.18987342,84.81012658,tract_part,http://www.prisonersofthecensus.org/data/2010blocks/210039204004019/
2.10E+14,9,0,0,0,0,2,0,11,54,65,16.92307692,83.07692308,tract_part,http://www.prisonersofthecensus.org/data/2010blocks/210079503003020/
2.10E+14,6,0,0,0,0,0,16,22,111,133,16.54135338,83.45864662,tract_part,http://www.prisonersofthecensus.org/data/2010blocks/210099505003054/
2.10E+14,96,0,0,0,0,0,0,96,202,298,32.2147651,67.7852349,tract_part,http://www.prisonersofthecensus.org/data/2010blocks/210139611002047/
2.10E+14,2,0,0,0,0,0,0,2,90,92,2.173913043,97.82608696,tract_part,http://www.prisonersofthecensus.org/data/2010blocks/210139602003023/
2.10E+14,7,0,0,0,0,0,1,8,45,53,15.09433962,84.90566038,institutionalized,http://www.prisonersofthecensus.org/data/2010blocks/210150705042000/
2.10E+14,57,0,1,0,1,0,78,137,243,380,36.05263158,63.94736842,institutionalized,http://www.prisonersofthecensus.org/data/2010blocks/210150705042003/
2.10E+14,11,0,0,0,0,2,12,25,99,124,20.16129032,79.83870968,tract_part,http://www.prisonersofthecensus.org/data/2010blocks/210170301001034/
2.10E+14,646,14,12,2,52,48,197,971,671,1642,59.13520097,40.86479903,tract_part,http://www.prisonersofthecensus.org/data/2010blocks/210190310023008/
2.10E+14,9,1,0,0,0,1,4,15,168,183,8.196721311,91.80327869,tract_part,http://www.prisonersofthecensus.org/data/2010blocks/210190313002042/
2.10E+14,27,0,0,0,0,5,7,39,171,210,18.57142857,81.42857143,tract_part,http://www.prisonersofthecensus.org/data/2010blocks/210219305001045/
2.10E+14,0,0,0,0,0,0,0,0,12,12,0,100,institutionalized,http://www.prisonersofthecensus.org/data/2010blocks/210219301001003/
2.10E+14,19,0,0,0,2,2,4,27,49,76,35.52631579,64.47368421,institutionalized,http://www.prisonersofthecensus.org/data/2010blocks/210219301001006/
2.10E+14,142,0,0,0,0,3,3,148,264,412,35.9223301,64.0776699,institutionalized,http://www.prisonersofthecensus.org/data/2010blocks/210219301001038/
2.10E+14,29,1,0,0,4,1,4,39,164,203,19.21182266,80.78817734,tract_part,http://www.prisonersofthecensus.org/data/2010blocks/210279602002032/
2.10E+14,19,0,0,0,1,1,1,22,244,266,8.270676692,91.72932331,tract_part,http://www.prisonersofthecensus.org/data/2010blocks/210290211012043/
2.10E+14,0,0,0,0,0,0,0,0,54,54,0,100,tract_part,http://www.prisonersofthecensus.org/data/2010blocks/210319303001029/
2.10E+14,5,0,0,0,0,3,1,9,22,31,29.03225806,70.96774194,tract_part,http://www.prisonersofthecensus.org/data/2010blocks/210339203001035/
2.10E+14,30,0,0,0,1,0,1,32,107,139,23.02158273,76.97841727,tract_part,http://www.prisonersofthecensus.org/data/2010blocks/210350104002024/
2.10E+14,10,1,0,0,0,1,1,13,37,50,26,74,institutionalized,http://www.prisonersofthecensus.org/data/2010blocks/210370532001037/
2.10E+14,96,4,0,0,4,8,14,126,397,523,24.0917782,75.9082218,institutionalized,http://www.prisonersofthecensus.org/data/2010blocks/210370532001039/
2.10E+14,7,0,0,0,0,0,2,9,128,137,6.569343066,93.43065693,tract_part,http://www.prisonersofthecensus.org/data/2010blocks/210419502002043/
2.10E+14,32,0,0,0,0,1,4,37,118,155,23.87096774,76.12903226,tract_part,http://www.prisonersofthecensus.org/data/2010blocks/210439605001043/
2.10E+14,30,0,0,0,0,0,3,33,278,311,10.61093248,89.38906752,tract_part,http://www.prisonersofthecensus.org/data/2010blocks/210459503002010/
2.10E+14,25,0,0,0,0,0,0,25,29,54,46.2962963,53.7037037,tract,http://www.prisonersofthecensus.org/data/2010blocks/210472001002013/
2.10E+14,248,0,0,0,1,0,9,258,276,534,48.31460674,51.68539326,tract,http://www.prisonersofthecensus.org/data/2010blocks/210472002001031/
2.10E+14,25,0,1,0,0,1,3,30,149,179,16.75977654,83.24022346,tract_part,http://www.prisonersofthecensus.org/data/2010blocks/210490201051003/
2.11E+14,642,12,4,2,50,18,269,997,697,1694,58.85478158,41.14521842,institutionalized,http://www.prisonersofthecensus.org/data/2010blocks/210519503002006/
2.11E+14,10,0,0,0,1,1,1,13,266,279,4.659498208,95.34050179,institutionalized,http://www.prisonersofthecensus.org/data/2010blocks/210519503004031/
2.11E+14,0,0,0,0,1,0,1,2,27,29,6.896551724,93.10344828,tract_part,http://www.prisonersofthecensus.org/data/2010blocks/210539702022025/
2.11E+14,32,0,0,0,0,0,3,35,100,135,25.92592593,74.07407407,tract_part,http://www.prisonersofthecensus.org/data/2010blocks/210559302003013/
2.11E+14,2,0,0,0,0,0,0,2,26,28,7.142857143,92.85714286,institutionalized,http://www.prisonersofthecensus.org/data/2010blocks/210590017022074/
2.11E+14,22,0,0,0,0,0,0,22,108,130,16.92307692,83.07692308,institutionalized,http://www.prisonersofthecensus.org/data/2010blocks/210590017022081/
2.11E+14,151,2,1,0,26,9,33,222,441,663,33.4841629,66.5158371,tract_part,http://www.prisonersofthecensus.org/data/2010blocks/210590014011039/
2.11E+14,261,4,2,0,5,2,17,291,712,1003,29.01296112,70.98703888,tract_part,http://www.prisonersofthecensus.org/data/2010blocks/210639201002041/
2.11E+14,0,0,0,0,0,0,0,0,32,32,0,100,tract_part,http://www.prisonersofthecensus.org/data/2010blocks/210659202004001/
2.11E+14,14,0,0,0,0,0,0,14,16,30,46.66666667,53.33333333,tract,http://www.prisonersofthecensus.org/data/2010blocks/210670009002007/
2.11E+14,24,0,0,0,1,1,1,27,41,68,39.70588235,60.29411765,tract,http://www.prisonersofthecensus.org/data/2010blocks/210670011004006/
2.11E+14,807,31,12,2,90,47,280,1269,621,1890,67.14285714,32.85714286,institutionalized,http://www.prisonersofthecensus.org/data/2010blocks/210670037012034/
2.11E+14,167,1,0,0,0,2,5,175,394,569,30.75571178,69.24428822,remaining,http://www.prisonersofthecensus.org/data/2010blocks/210670037012037/
2.11E+14,87,3,2,0,0,11,16,119,182,301,39.53488372,60.46511628,tract,http://www.prisonersofthecensus.org/data/2010blocks/210670037022009/
2.11E+14,0,0,0,0,0,0,0,0,154,154,0,100,tract_part,http://www.prisonersofthecensus.org/data/2010blocks/210719201004042/
2.11E+14,48,0,0,0,1,0,1,50,160,210,23.80952381,76.19047619,tract_part,http://www.prisonersofthecensus.org/data/2010blocks/210719205003012/
2.11E+14,147,1,0,0,1,5,7,161,304,465,34.62365591,65.37634409,tract_part,http://www.prisonersofthecensus.org/data/2010blocks/210730706003072/
2.11E+14,0,0,1,0,0,0,0,1,52,53,1.886792453,98.11320755,tract,http://www.prisonersofthecensus.org/data/2010blocks/210730710003020/
2.11E+14,142,1,0,0,0,1,0,144,244,388,37.11340206,62.88659794,tract_part,http://www.prisonersofthecensus.org/data/2010blocks/210759602004092/
2.11E+14,51,0,1,0,2,0,8,62,230,292,21.23287671,78.76712329,tract_part,http://www.prisonersofthecensus.org/data/2010blocks/210819203006006/
2.11E+14,7,0,0,0,0,0,1,8,23,31,25.80645161,74.19354839,institutionalized,http://www.prisonersofthecensus.org/data/2010blocks/210830203002004/
2.11E+14,19,0,0,0,1,1,4,25,28,53,47.16981132,52.83018868,institutionalized,http://www.prisonersofthecensus.org/data/2010blocks/210830203002011/
2.11E+14,154,1,2,0,4,0,33,194,413,607,31.96046129,68.03953871,tract_part,http://www.prisonersofthecensus.org/data/2010blocks/210859503002015/
2.11E+14,0,0,0,0,0,1,1,2,128,130,1.538461538,98.46153846,tract_part,http://www.prisonersofthecensus.org/data/2010blocks/210890405022004/
2.11E+14,159,0,0,0,1,0,6,166,460,626,26.51757188,73.48242812,tract_part,http://www.prisonersofthecensus.org/data/2010blocks/210930016001041/
2.11E+14,7,0,1,0,0,2,1,11,181,192,5.729166667,94.27083333,tract_part,http://www.prisonersofthecensus.org/data/2010blocks/210959710002002/
2.11E+14,25,0,0,0,1,0,1,27,95,122,22.13114754,77.86885246,tract_part,http://www.prisonersofthecensus.org/data/2010blocks/210999703003009/
2.11E+14,173,0,1,0,2,2,7,185,362,547,33.82084095,66.17915905,tract_part,http://www.prisonersofthecensus.org/data/2010blocks/211010206022034/
2.11E+14,16,1,0,0,0,0,1,18,55,73,24.65753425,75.34246575,tract_part,http://www.prisonersofthecensus.org/data/2010blocks/211059701004070/
2.11E+14,124,0,0,0,3,2,6,135,320,455,29.67032967,70.32967033,tract_part,http://www.prisonersofthecensus.org/data/2010blocks/211079703005023/
2.11E+14,0,0,0,0,0,0,0,0,34,34,0,100,tract_part,http://www.prisonersofthecensus.org/data/2010blocks/211099601003017/
2.11E+14,846,1,2,0,12,2,57,920,673,1593,57.75266792,42.24733208,tract,http://www.prisonersofthecensus.org/data/2010blocks/211110049001070/
2.11E+14,228,0,2,0,0,1,11,242,197,439,55.12528474,44.87471526,tract,http://www.prisonersofthecensus.org/data/2010blocks/211110059002018/
2.11E+14,10,0,0,0,0,0,1,11,29,40,27.5,72.5,tract_part,http://www.prisonersofthecensus.org/data/2010blocks/211110071002002/
2.11E+14,16,0,0,0,0,0,0,16,125,141,11.34751773,88.65248227,tract,http://www.prisonersofthecensus.org/data/2010blocks/211110043023011/
2.11E+14,68,0,1,0,0,2,0,71,153,224,31.69642857,68.30357143,tract,http://www.prisonersofthecensus.org/data/2010blocks/211110002003043/
2.11E+14,4,0,0,0,0,0,0,4,1,5,80,20,tract,http://www.prisonersofthecensus.org/data/2010blocks/211110024003022/
2.11E+14,34,1,0,0,0,1,0,36,49,85,42.35294118,57.64705882,tract,http://www.prisonersofthecensus.org/data/2010blocks/211110027001061/
2.11E+14,29,0,0,0,0,1,0,30,58,88,34.09090909,65.90909091,tract,http://www.prisonersofthecensus.org/data/2010blocks/211110030001009/
2.11E+14,24,1,1,0,0,0,0,26,43,69,37.68115942,62.31884058,tract,http://www.prisonersofthecensus.org/data/2010blocks/211110035002000/
2.11E+14,20,0,0,0,1,1,6,28,163,191,14.65968586,85.34031414,tract_part,http://www.prisonersofthecensus.org/data/2010blocks/211130601022023/
2.11E+14,3,0,0,0,0,1,5,9,222,231,3.896103896,96.1038961,tract_part,http://www.prisonersofthecensus.org/data/2010blocks/211159604002025/
2.11E+14,115,0,0,0,0,0,9,124,374,498,24.89959839,75.10040161,tract,http://www.prisonersofthecensus.org/data/2010blocks/211170670001055/
2.11E+14,0,0,0,0,0,0,0,0,53,53,0,100,tract_part,http://www.prisonersofthecensus.org/data/2010blocks/211219305003028/
2.11E+14,30,3,1,0,6,4,10,54,103,157,34.39490446,65.60509554,tract_part,http://www.prisonersofthecensus.org/data/2010blocks/211239601026018/
2.11E+14,9,0,1,0,0,1,2,13,317,330,3.939393939,96.06060606,tract,http://www.prisonersofthecensus.org/data/2010blocks/211259706003004/
2.11E+14,6,0,0,0,0,0,8,14,171,185,7.567567568,92.43243243,tract_part,http://www.prisonersofthecensus.org/data/2010blocks/211299501003005/
2.11E+14,156,7,3,0,3,1,21,191,631,822,23.23600973,76.76399027,tract_part,http://www.prisonersofthecensus.org/data/2010blocks/211299501004005/
2.11E+14,5,0,0,0,0,0,1,6,127,133,4.511278195,95.4887218,tract_part,http://www.prisonersofthecensus.org/data/2010blocks/211319201003009/
2.11E+14,1,0,0,0,0,0,0,1,58,59,1.694915254,98.30508475,tract_part,http://www.prisonersofthecensus.org/data/2010blocks/211339504023058/
2.11E+14,2,0,0,0,0,0,0,2,51,53,3.773584906,96.22641509,tract_part,http://www.prisonersofthecensus.org/data/2010blocks/211359302003041/
2.11E+14,9,1,0,0,0,0,2,12,86,98,12.24489796,87.75510204,tract_part,http://www.prisonersofthecensus.org/data/2010blocks/211379201024024/
2.11E+14,17,0,0,0,1,5,4,27,71,98,27.55102041,72.44897959,tract_part,http://www.prisonersofthecensus.org/data/2010blocks/211419604002111/
2.11E+14,276,0,1,0,6,2,14,299,564,863,34.64658169,65.35341831,tract_part,http://www.prisonersofthecensus.org/data/2010blocks/211439601005090/
2.11E+14,37,0,0,0,0,0,0,37,101,138,26.8115942,73.1884058,tract_part,http://www.prisonersofthecensus.org/data/2010blocks/211439601001012/
2.11E+14,31,0,0,0,0,0,0,31,69,100,31,69,tract_part,http://www.prisonersofthecensus.org/data/2010blocks/211450302001024/
2.11E+14,96,0,1,0,1,1,6,105,233,338,31.06508876,68.93491124,tract_part,http://www.prisonersofthecensus.org/data/2010blocks/211450303001056/
2.11E+14,904,63,7,3,102,63,277,1419,401,1820,77.96703297,22.03296703,tract_part,http://www.prisonersofthecensus.org/data/2010blocks/211479604005005/
2.11E+14,0,0,0,0,0,1,2,3,77,80,3.75,96.25,tract_part,http://www.prisonersofthecensus.org/data/2010blocks/211479603005021/
2.12E+14,19,1,0,0,5,3,11,39,158,197,19.79695431,80.20304569,tract,http://www.prisonersofthecensus.org/data/2010blocks/211510104001007/
2.12E+14,17,0,0,0,1,0,1,19,56,75,25.33333333,74.66666667,tract_part,http://www.prisonersofthecensus.org/data/2010blocks/211510109021072/
2.12E+14,91,1,1,0,7,6,14,120,147,267,44.94382022,55.05617978,tract_part,http://www.prisonersofthecensus.org/data/2010blocks/211559702004026/
2.12E+14,258,5,4,0,4,17,19,307,489,796,38.5678392,61.4321608,tract,http://www.prisonersofthecensus.org/data/2010blocks/211559703001055/
2.12E+14,7,0,0,0,0,0,1,8,90,98,8.163265306,91.83673469,institutionalized,http://www.prisonersofthecensus.org/data/2010blocks/211579504002005/
2.12E+14,9,0,0,0,0,0,0,9,54,63,14.28571429,85.71428571,institutionalized,http://www.prisonersofthecensus.org/data/2010blocks/211579504002012/
2.12E+14,884,27,12,0,0,6,340,1269,327,1596,79.5112782,20.4887218,tract_part,http://www.prisonersofthecensus.org/data/2010blocks/211599502005054/
2.12E+14,14,0,0,0,0,0,0,14,150,164,8.536585366,91.46341463,tract_part,http://www.prisonersofthecensus.org/data/2010blocks/211619603001023/
2.12E+14,26,0,3,0,0,0,0,29,118,147,19.72789116,80.27210884,tract_part,http://www.prisonersofthecensus.org/data/2010blocks/211639704022007/
2.12E+14,4,0,0,0,0,0,2,6,20,26,23.07692308,76.92307692,tract_part,http://www.prisonersofthecensus.org/data/2010blocks/211719303001046/
2.12E+14,4,0,0,0,0,0,5,9,123,132,6.818181818,93.18181818,tract_part,http://www.prisonersofthecensus.org/data/2010blocks/211739203021005/
2.12E+14,581,8,17,0,7,29,47,689,1207,1896,36.33966245,63.66033755,tract_part,http://www.prisonersofthecensus.org/data/2010blocks/211759504003076/
2.12E+14,292,0,0,0,2,1,16,311,639,950,32.73684211,67.26315789,tract_part,http://www.prisonersofthecensus.org/data/2010blocks/211779602002009/
2.12E+14,27,2,2,0,0,0,4,35,230,265,13.20754717,86.79245283,tract_part,http://www.prisonersofthecensus.org/data/2010blocks/211779606002018/
2.12E+14,15,1,0,0,0,2,1,19,81,100,19,81,tract_part,http://www.prisonersofthecensus.org/data/2010blocks/211799303012059/
2.12E+14,18,0,0,0,0,0,7,25,46,71,35.21126761,64.78873239,tract_part,http://www.prisonersofthecensus.org/data/2010blocks/211839203004060/
2.12E+14,291,11,1,0,4,12,23,342,657,999,34.23423423,65.76576577,institutionalized,http://www.prisonersofthecensus.org/data/2010blocks/211850302002008/
2.12E+14,474,24,7,1,23,46,69,644,1342,1986,32.42698892,67.57301108,institutionalized,http://www.prisonersofthecensus.org/data/2010blocks/211850302002013/
2.12E+14,49,0,0,0,4,1,21,75,63,138,54.34782609,45.65217391,tract_part,http://www.prisonersofthecensus.org/data/2010blocks/211850303011011/
2.12E+14,351,11,2,1,13,31,32,441,730,1171,37.66011956,62.33988044,tract_part,http://www.prisonersofthecensus.org/data/2010blocks/211850302001005/
2.12E+14,3,0,0,0,1,2,1,7,157,164,4.268292683,95.73170732,tract_part,http://www.prisonersofthecensus.org/data/2010blocks/211939704002047/
2.12E+14,18,0,0,0,0,0,2,20,298,318,6.289308176,93.71069182,tract,http://www.prisonersofthecensus.org/data/2010blocks/211959303001029/
2.12E+14,4,0,0,0,0,2,2,8,101,109,7.339449541,92.66055046,tract_part,http://www.prisonersofthecensus.org/data/2010blocks/211979701003007/
2.12E+14,12,0,0,0,5,0,4,21,210,231,9.090909091,90.90909091,tract_part,http://www.prisonersofthecensus.org/data/2010blocks/211999305023022/
2.12E+14,4,1,0,0,0,1,1,7,96,103,6.796116505,93.2038835,tract_part,http://www.prisonersofthecensus.org/data/2010blocks/212039502005039/
2.12E+14,4,0,0,0,0,0,3,7,83,90,7.777777778,92.22222222,tract_part,http://www.prisonersofthecensus.org/data/2010blocks/212059502004002/
2.12E+14,0,0,0,0,0,0,0,0,16,16,0,100,tract_part,http://www.prisonersofthecensus.org/data/2010blocks/212079603002030/
2.12E+14,9,0,0,0,8,0,8,25,55,80,31.25,68.75,tract_part,http://www.prisonersofthecensus.org/data/2010blocks/212090401003026/
2.12E+14,0,0,0,0,0,0,0,0,3,3,0,100,tract_part,http://www.prisonersofthecensus.org/data/2010blocks/212090406031020/
2.12E+14,65,2,2,3,8,10,19,109,228,337,32.34421365,67.65578635,tract_part,http://www.prisonersofthecensus.org/data/2010blocks/212110402004016/
2.12E+14,111,3,1,0,6,12,11,144,580,724,19.88950276,80.11049724,tract_part,http://www.prisonersofthecensus.org/data/2010blocks/212110405021009/
2.12E+14,83,0,0,0,0,0,6,89,110,199,44.72361809,55.27638191,tract_part,http://www.prisonersofthecensus.org/data/2010blocks/212139703001021/
2.12E+14,33,0,0,0,0,0,4,37,140,177,20.9039548,79.0960452,tract_part,http://www.prisonersofthecensus.org/data/2010blocks/212179205006033/
2.12E+14,43,0,0,0,0,0,2,45,78,123,36.58536585,63.41463415,tract_part,http://www.prisonersofthecensus.org/data/2010blocks/212199502004028/
2.12E+14,8,0,0,0,0,0,1,9,34,43,20.93023256,79.06976744,tract_part,http://www.prisonersofthecensus.org/data/2010blocks/212259502022080/
2.12E+14,191,0,2,0,0,1,6,200,401,601,33.27787022,66.72212978,tract,http://www.prisonersofthecensus.org/data/2010blocks/212270101001001/
2.12E+14,7,0,0,0,0,1,0,8,178,186,4.301075269,95.69892473,tract_part,http://www.prisonersofthecensus.org/data/2010blocks/212319202002024/
2.12E+14,49,0,1,0,0,0,0,50,195,245,20.40816327,79.59183673,tract_part,http://www.prisonersofthecensus.org/data/2010blocks/212339602002037/
2.12E+14,1,0,0,0,0,1,0,2,232,234,0.854700855,99.14529915,tract_part,http://www.prisonersofthecensus.org/data/2010blocks/212359206005040/
2.12E+14,13,0,0,0,0,0,5,18,49,67,26.86567164,73.13432836,tract_part,http://www.prisonersofthecensus.org/data/2010blocks/212390501031007/
2.20E+14,63,0,0,0,2,0,2,67,67,134,50,50,tract_part,http://www.prisonersofthecensus.org/data/2010blocks/220019608003062/
2.20E+14,74,0,0,0,2,0,3,79,32,111,71.17117117,28.82882883,tract_part,http://www.prisonersofthecensus.org/data/2010blocks/220019609001057/
2.20E+14,11,0,0,0,0,0,0,11,8,19,57.89473684,42.10526316,tract_part,http://www.prisonersofthecensus.org/data/2010blocks/220019607001021/
2.20E+14,2,0,0,0,0,0,0,2,4,6,33.33333333,66.66666667,tract_part,http://www.prisonersofthecensus.org/data/2010blocks/220039502001015/
2.20E+14,867,9,17,0,0,2,2,897,1533,2430,36.91358025,63.08641975,tract_part,http://www.prisonersofthecensus.org/data/2010blocks/220039502004001/
2.20E+14,18,0,0,0,0,0,0,18,29,47,38.29787234,61.70212766,tract_part,http://www.prisonersofthecensus.org/data/2010blocks/220039504003044/
2.20E+14,1060,1,0,0,1,9,9,1080,391,1471,73.41944256,26.58055744,tract_part,http://www.prisonersofthecensus.org/data/2010blocks/220039505004027/
2.20E+14,229,0,0,0,0,0,3,232,228,460,50.43478261,49.56521739,tract_part,http://www.prisonersofthecensus.org/data/2010blocks/220050310001009/
2.20E+14,50,1,0,0,0,1,5,57,18,75,76,24,tract_part,http://www.prisonersofthecensus.org/data/2010blocks/220070504002060/
2.20E+14,269,0,0,0,0,4,1,274,142,416,65.86538462,34.13461538,tract_part,http://www.prisonersofthecensus.org/data/2010blocks/220090304001081/
2.20E+14,194,0,0,0,0,0,0,194,65,259,74.9034749,25.0965251,tract_part,http://www.prisonersofthecensus.org/data/2010blocks/220090307001029/
2.20E+14,1217,0,1,0,0,1,20,1239,494,1733,71.49451818,28.50548182,tract_part,http://www.prisonersofthecensus.org/data/2010blocks/220090307002003/
2.20E+14,109,0,0,0,0,11,16,136,150,286,47.55244755,52.44755245,tract_part,http://www.prisonersofthecensus.org/data/2010blocks/220090309002108/
2.20E+14,586,0,1,0,1,0,5,593,329,922,64.31670282,35.68329718,tract_part,http://www.prisonersofthecensus.org/data/2010blocks/220119607001281/
2.20E+14,66,0,0,0,0,0,1,67,99,166,40.36144578,59.63855422,tract_part,http://www.prisonersofthecensus.org/data/2010blocks/220119604002017/
2.20E+14,25,0,0,0,1,1,1,28,17,45,62.22222222,37.77777778,tract_part,http://www.prisonersofthecensus.org/data/2010blocks/220139701004057/
2.20E+14,123,0,2,0,3,0,9,137,116,253,54.15019763,45.84980237,tract_part,http://www.prisonersofthecensus.org/data/2010blocks/220150112004031/
2.20E+14,40,0,0,0,1,0,1,42,19,61,68.85245902,31.14754098,tract_part,http://www.prisonersofthecensus.org/data/2010blocks/220150106022000/
2.20E+14,0,0,0,0,0,1,0,1,1,2,50,50,tract_part,http://www.prisonersofthecensus.org/data/2010blocks/220150109002063/
2.20E+14,1138,0,1,0,0,1,18,1158,368,1526,75.88466579,24.11533421,tract_part,http://www.prisonersofthecensus.org/data/2010blocks/220170246025012/
2.20E+14,11,0,0,0,0,0,0,11,3,14,78.57142857,21.42857143,tract,http://www.prisonersofthecensus.org/data/2010blocks/220170252001005/
2.20E+14,3,0,0,0,0,0,0,3,3,6,50,50,tract,http://www.prisonersofthecensus.org/data/2010blocks/220170211001010/
2.20E+14,341,0,0,0,0,0,0,341,309,650,52.46153846,47.53846154,tract_part,http://www.prisonersofthecensus.org/data/2010blocks/220170242033057/
2.20E+14,133,0,1,0,0,0,0,134,80,214,62.61682243,37.38317757,institutionalized,http://www.prisonersofthecensus.org/data/2010blocks/220190016001000/
2.20E+14,658,1,2,0,0,0,40,701,468,1169,59.96578272,40.03421728,institutionalized,http://www.prisonersofthecensus.org/data/2010blocks/220190016003000/
2.20E+14,70,0,0,0,0,0,0,70,49,119,58.82352941,41.17647059,tract_part,http://www.prisonersofthecensus.org/data/2010blocks/220190016001057/
2.20E+14,14,0,0,0,0,0,0,14,26,40,35,65,tract_part,http://www.prisonersofthecensus.org/data/2010blocks/220210002003020/
2.20E+14,309,2,1,0,4,3,9,328,138,466,70.38626609,29.61373391,tract_part,http://www.prisonersofthecensus.org/data/2010blocks/220210003001025/
2.20E+14,6,0,0,0,0,0,0,6,9,15,40,60,tract_part,http://www.prisonersofthecensus.org/data/2010blocks/220250001002042/
2.20E+14,571,0,0,0,0,3,1,575,204,779,73.81258023,26.18741977,tract_part,http://www.prisonersofthecensus.org/data/2010blocks/220250001002018/
2.20E+14,2065,0,2,1,1,3,3,2075,693,2768,74.96387283,25.03612717,tract_part,http://www.prisonersofthecensus.org/data/2010blocks/220279502003010/
2.20E+14,65,0,0,0,0,0,0,65,78,143,45.45454545,54.54545455,tract_part,http://www.prisonersofthecensus.org/data/2010blocks/220290003002042/
2.20E+14,776,3,2,2,1,7,26,817,353,1170,69.82905983,30.17094017,tract_part,http://www.prisonersofthecensus.org/data/2010blocks/220290005003000/
2.20E+14,66,0,0,0,0,0,0,66,32,98,67.34693878,32.65306122,tract_part,http://www.prisonersofthecensus.org/data/2010blocks/220319504001013/
2.20E+14,114,0,1,0,0,0,3,118,66,184,64.13043478,35.86956522,tract_part,http://www.prisonersofthecensus.org/data/2010blocks/220330046031013/
2.20E+14,1689,0,5,0,8,2,17,1721,443,2164,79.52865065,20.47134935,tract,http://www.prisonersofthecensus.org/data/2010blocks/220330031031018/
2.20E+14,14,0,0,0,0,0,0,14,10,24,58.33333333,41.66666667,tract,http://www.prisonersofthecensus.org/data/2010blocks/220330011041011/
2.20E+14,78,0,0,0,1,0,2,81,18,99,81.81818182,18.18181818,institutionalized,http://www.prisonersofthecensus.org/data/2010blocks/220350002002013/
2.20E+14,321,4,2,0,5,4,10,346,88,434,79.7235023,20.2764977,institutionalized,http://www.prisonersofthecensus.org/data/2010blocks/220350002002111/
2.20E+14,421,2,0,0,1,2,10,436,108,544,80.14705882,19.85294118,institutionalized,http://www.prisonersofthecensus.org/data/2010blocks/220350002002160/
2.20E+14,160,0,0,0,0,5,4,169,38,207,81.64251208,18.35748792,institutionalized,http://www.prisonersofthecensus.org/data/2010blocks/220379515021022/
2.20E+14,987,0,2,1,6,27,39,1062,325,1387,76.56813266,23.43186734,remaining,http://www.prisonersofthecensus.org/data/2010blocks/220379515021035/
2.20E+14,47,1,2,0,99,0,197,346,39,385,89.87012987,10.12987013,tract_part,http://www.prisonersofthecensus.org/data/2010blocks/220399503005007/
2.20E+14,45,2,2,0,61,3,116,229,27,256,89.453125,10.546875,tract_part,http://www.prisonersofthecensus.org/data/2010blocks/220399503005006/
2.20E+14,460,0,1,0,0,0,2,463,123,586,79.01023891,20.98976109,tract_part,http://www.prisonersofthecensus.org/data/2010blocks/220399501003024/
2.20E+14,232,0,2,0,3,2,7,246,108,354,69.49152542,30.50847458,tract_part,http://www.prisonersofthecensus.org/data/2010blocks/220419502001150/
2.20E+14,32,0,0,0,0,0,0,32,66,98,32.65306122,67.34693878,tract_part,http://www.prisonersofthecensus.org/data/2010blocks/220430203002199/
2.20E+14,1499,48,18,4,0,28,653,2250,441,2691,83.61204013,16.38795987,tract_part,http://www.prisonersofthecensus.org/data/2010blocks/220430204022061/
2.20E+14,299,0,2,0,4,4,15,324,158,482,67.21991701,32.78008299,tract_part,http://www.prisonersofthecensus.org/data/2010blocks/220450303011082/
2.20E+14,1044,3,1,0,0,15,23,1086,765,1851,58.67098865,41.32901135,institutionalized,http://www.prisonersofthecensus.org/data/2010blocks/220479532004002/
2.20E+14,1121,0,2,0,1,11,53,1188,539,1727,68.78980892,31.21019108,institutionalized,http://www.prisonersofthecensus.org/data/2010blocks/220479532004004/
2.21E+14,561,3,0,0,0,18,5,587,231,818,71.7603912,28.2396088,tract_part,http://www.prisonersofthecensus.org/data/2010blocks/220499703001052/
2.21E+14,623,0,1,0,0,1,16,641,304,945,67.83068783,32.16931217,tract_part,http://www.prisonersofthecensus.org/data/2010blocks/220510259001012/
2.21E+14,34,0,0,0,6,0,6,46,34,80,57.5,42.5,institutionalized,http://www.prisonersofthecensus.org/data/2010blocks/220530005001054/
2.21E+14,28,0,0,0,0,0,0,28,18,46,60.86956522,39.13043478,institutionalized,http://www.prisonersofthecensus.org/data/2010blocks/220530005001074/
2.21E+14,668,0,0,0,0,0,21,689,397,1086,63.44383057,36.55616943,tract_part,http://www.prisonersofthecensus.org/data/2010blocks/220550001001027/
2.21E+14,72,1,0,0,0,0,4,77,88,165,46.66666667,53.33333333,tract_part,http://www.prisonersofthecensus.org/data/2010blocks/220570205005027/
2.21E+14,114,1,0,0,1,0,2,118,80,198,59.5959596,40.4040404,tract_part,http://www.prisonersofthecensus.org/data/2010blocks/220570210001119/
2.21E+14,388,0,0,0,1,0,7,396,211,607,65.23887974,34.76112026,tract_part,http://www.prisonersofthecensus.org/data/2010blocks/220599701002060/
2.21E+14,3,0,0,0,0,0,0,3,10,13,23.07692308,76.92307692,tract_part,http://www.prisonersofthecensus.org/data/2010blocks/220599702005028/
2.21E+14,113,2,5,1,60,7,179,367,138,505,72.67326733,27.32673267,tract_part,http://www.prisonersofthecensus.org/data/2010blocks/220599702003026/
2.21E+14,129,1,0,0,1,2,7,140,43,183,76.50273224,23.49726776,tract_part,http://www.prisonersofthecensus.org/data/2010blocks/220619605001040/
2.21E+14,6,0,0,0,0,0,2,8,16,24,33.33333333,66.66666667,tract_part,http://www.prisonersofthecensus.org/data/2010blocks/220619606004006/
2.21E+14,114,1,1,0,0,0,4,120,404,524,22.90076336,77.09923664,tract_part,http://www.prisonersofthecensus.org/data/2010blocks/220630402022114/
2.21E+14,735,0,3,0,0,2,6,746,175,921,80.99891422,19.00108578,tract_part,http://www.prisonersofthecensus.org/data/2010blocks/220659602001166/
2.21E+14,282,5,2,0,6,7,13,315,177,492,64.02439024,35.97560976,tract_part,http://www.prisonersofthecensus.org/data/2010blocks/220659603002020/
2.21E+14,21,0,0,0,0,0,0,21,5,26,80.76923077,19.23076923,tract_part,http://www.prisonersofthecensus.org/data/2010blocks/220659605001012/
2.21E+14,208,0,0,0,2,3,5,218,48,266,81.95488722,18.04511278,tract_part,http://www.prisonersofthecensus.org/data/2010blocks/220679507001079/
2.21E+14,108,0,0,0,0,1,2,111,42,153,72.54901961,27.45098039,tract_part,http://www.prisonersofthecensus.org/data/2010blocks/220679505002022/
2.21E+14,55,0,0,0,0,0,0,55,15,70,78.57142857,21.42857143,tract_part,http://www.prisonersofthecensus.org/data/2010blocks/220679504002034/
2.21E+14,374,0,0,0,0,1,1,376,85,461,81.56182213,18.43817787,tract_part,http://www.prisonersofthecensus.org/data/2010blocks/220690006004012/
2.21E+14,8,0,0,0,0,0,0,8,0,8,100,0,tract,http://www.prisonersofthecensus.org/data/2010blocks/220710008003002/
2.21E+14,51,0,3,0,0,0,2,56,20,76,73.68421053,26.31578947,tract,http://www.prisonersofthecensus.org/data/2010blocks/220710023005056/
2.21E+14,340,0,0,0,0,0,0,340,49,389,87.40359897,12.59640103,tract,http://www.prisonersofthecensus.org/data/2010blocks/220710060001004/
2.21E+14,89,0,0,0,0,0,0,89,10,99,89.8989899,10.1010101,tract,http://www.prisonersofthecensus.org/data/2010blocks/220710063002012/
2.21E+14,2,0,2,0,1,0,1,6,4,10,60,40,tract,http://www.prisonersofthecensus.org/data/2010blocks/220710065003014/
2.21E+14,0,0,0,0,0,0,0,0,4,4,0,100,tract,http://www.prisonersofthecensus.org/data/2010blocks/220710123002019/
2.21E+14,11,0,11,0,4,1,8,35,74,109,32.11009174,67.88990826,tract,http://www.prisonersofthecensus.org/data/2010blocks/220710134002010/
2.21E+14,831,1,2,0,0,7,19,860,66,926,92.87257019,7.127429806,institutionalized,http://www.prisonersofthecensus.org/data/2010blocks/220710145001000/
2.21E+14,667,0,1,0,0,11,6,685,103,788,86.92893401,13.07106599,institutionalized,http://www.prisonersofthecensus.org/data/2010blocks/220710145001005/
2.21E+14,173,1,0,0,16,0,86,276,54,330,83.63636364,16.36363636,institutionalized,http://www.prisonersofthecensus.org/data/2010blocks/220710145001009/
2.21E+14,918,0,4,0,1,7,25,955,122,1077,88.6722377,11.3277623,institutionalized,http://www.prisonersofthecensus.org/data/2010blocks/220710145001013/
2.21E+14,20,0,0,0,0,2,1,23,30,53,43.39622642,56.60377358,tract_part,http://www.prisonersofthecensus.org/data/2010blocks/220730054002023/
2.21E+14,698,0,3,0,0,0,1,702,225,927,75.72815534,24.27184466,institutionalized,http://www.prisonersofthecensus.org/data/2010blocks/220730106033025/
2.21E+14,593,0,1,0,7,0,27,628,306,934,67.23768737,32.76231263,institutionalized,http://www.prisonersofthecensus.org/data/2010blocks/220730106034017/
2.21E+14,7,0,0,0,0,0,0,7,9,16,43.75,56.25,tract,http://www.prisonersofthecensus.org/data/2010blocks/220730014001067/
2.21E+14,143,0,0,0,1,1,3,148,54,202,73.26732673,26.73267327,tract_part,http://www.prisonersofthecensus.org/data/2010blocks/220730110001015/
2.21E+14,4,0,0,0,0,0,0,4,4,8,50,50,tract_part,http://www.prisonersofthecensus.org/data/2010blocks/220750502005023/
2.21E+14,12,0,0,0,0,0,0,12,6,18,66.66666667,33.33333333,tract_part,http://www.prisonersofthecensus.org/data/2010blocks/220750505002031/
2.21E+14,440,1,0,0,1,0,64,506,81,587,86.20102215,13.79897785,tract_part,http://www.prisonersofthecensus.org/data/2010blocks/220790137002062/
2.21E+14,229,0,0,0,1,0,2,232,111,343,67.63848397,32.36151603,tract_part,http://www.prisonersofthecensus.org/data/2010blocks/220790139001120/
2.21E+14,1,0,0,0,0,0,0,1,9,10,10,90,remaining,http://www.prisonersofthecensus.org/data/2010blocks/220790138003028/
2.21E+14,399,0,0,0,0,0,1,400,210,610,65.57377049,34.42622951,institutionalized,http://www.prisonersofthecensus.org/data/2010blocks/220790138003040/
2.21E+14,53,0,0,0,0,0,1,54,21,75,72,28,tract_part,http://www.prisonersofthecensus.org/data/2010blocks/220819603002084/
2.21E+14,425,5,1,0,0,6,17,454,261,715,63.4965035,36.5034965,tract_part,http://www.prisonersofthecensus.org/data/2010blocks/220839704002225/
2.21E+14,55,0,0,0,0,1,12,68,54,122,55.73770492,44.26229508,institutionalized,http://www.prisonersofthecensus.org/data/2010blocks/220850005003015/
2.21E+14,4,3,0,0,1,0,6,14,30,44,31.81818182,68.18181818,institutionalized,http://www.prisonersofthecensus.org/data/2010blocks/220850005004019/
2.21E+14,109,0,0,0,0,0,6,115,113,228,50.43859649,49.56140351,tract_part,http://www.prisonersofthecensus.org/data/2010blocks/220870304002118/
2.21E+14,363,1,1,0,0,0,3,368,137,505,72.87128713,27.12871287,tract_part,http://www.prisonersofthecensus.org/data/2010blocks/220890627002181/
2.21E+14,36,0,0,0,0,0,0,36,11,47,76.59574468,23.40425532,tract_part,http://www.prisonersofthecensus.org/data/2010blocks/220919511004040/
2.21E+14,74,1,0,0,0,0,4,79,15,94,84.04255319,15.95744681,tract_part,http://www.prisonersofthecensus.org/data/2010blocks/220930404002154/
2.21E+14,146,1,0,0,0,0,5,152,54,206,73.78640777,26.21359223,institutionalized,http://www.prisonersofthecensus.org/data/2010blocks/220950709002026/
2.21E+14,17,0,0,0,0,0,0,17,3,20,85,15,institutionalized,http://www.prisonersofthecensus.org/data/2010blocks/220950709002061/
2.21E+14,109,1,0,0,1,1,3,115,65,180,63.88888889,36.11111111,tract_part,http://www.prisonersofthecensus.org/data/2010blocks/220979613002050/
2.21E+14,37,0,0,0,1,0,0,38,3,41,92.68292683,7.317073171,tract_part,http://www.prisonersofthecensus.org/data/2010blocks/220979614004016/
2.21E+14,29,0,0,0,0,0,0,29,25,54,53.7037037,46.2962963,tract,http://www.prisonersofthecensus.org/data/2010blocks/220979611001017/
2.21E+14,101,1,0,0,0,0,8,110,61,171,64.32748538,35.67251462,tract_part,http://www.prisonersofthecensus.org/data/2010blocks/220990209001046/
2.21E+14,175,1,0,0,1,1,7,185,93,278,66.54676259,33.45323741,tract_part,http://www.prisonersofthecensus.org/data/2010blocks/220990205013000/
2.21E+14,33,0,0,0,0,0,1,34,25,59,57.62711864,42.37288136,institutionalized,http://www.prisonersofthecensus.org/data/2010blocks/221010415001021/
2.21E+14,6,0,0,0,0,0,0,6,3,9,66.66666667,33.33333333,institutionalized,http://www.prisonersofthecensus.org/data/2010blocks/221010415001024/
2.21E+14,206,0,1,0,4,0,20,231,67,298,77.51677852,22.48322148,tract_part,http://www.prisonersofthecensus.org/data/2010blocks/221010409002269/
2.21E+14,17,0,0,0,1,0,1,19,5,24,79.16666667,20.83333333,tract_part,http://www.prisonersofthecensus.org/data/2010blocks/221010407003001/
2.21E+14,26,0,0,0,1,0,2,29,21,50,58,42,tract_part,http://www.prisonersofthecensus.org/data/2010blocks/221010402001038/
2.21E+14,2,0,0,0,0,0,0,2,8,10,20,80,tract_part,http://www.prisonersofthecensus.org/data/2010blocks/221010405001067/
2.21E+14,43,0,0,0,0,0,3,46,72,118,38.98305085,61.01694915,tract_part,http://www.prisonersofthecensus.org/data/2010blocks/221030407043033/
2.21E+14,369,0,1,0,0,1,7,378,214,592,63.85135135,36.14864865,tract_part,http://www.prisonersofthecensus.org/data/2010blocks/221059534003035/
2.21E+14,20,0,0,0,0,0,0,20,1,21,95.23809524,4.761904762,tract_part,http://www.prisonersofthecensus.org/data/2010blocks/221059544003030/
2.21E+14,13,0,0,0,0,0,1,14,2,16,87.5,12.5,tract_part,http://www.prisonersofthecensus.org/data/2010blocks/221070003001156/
2.21E+14,347,17,1,0,13,1,30,409,393,802,50.99750623,49.00249377,tract_part,http://www.prisonersofthecensus.org/data/2010blocks/221090013004031/
2.21E+14,252,3,1,0,0,2,5,263,78,341,77.12609971,22.87390029,tract_part,http://www.prisonersofthecensus.org/data/2010blocks/221119604002018/
2.21E+14,9,0,0,0,0,0,1,10,6,16,62.5,37.5,tract_part,http://www.prisonersofthecensus.org/data/2010blocks/221159504002053/
2.21E+14,26,0,0,0,0,0,1,27,51,78,34.61538462,65.38461538,tract_part,http://www.prisonersofthecensus.org/data/2010blocks/221159505001024/
2.21E+14,17,0,0,0,0,0,0,17,22,39,43.58974359,56.41025641,tract_part,http://www.prisonersofthecensus.org/data/2010blocks/221179509001014/
2.21E+14,807,0,0,0,0,2,4,813,313,1126,72.20248668,27.79751332,tract_part,http://www.prisonersofthecensus.org/data/2010blocks/221179501012106/
2.21E+14,69,0,0,0,0,0,0,69,69,138,50,50,tract_part,http://www.prisonersofthecensus.org/data/2010blocks/221179505002046/
2.21E+14,134,0,0,0,0,0,1,135,68,203,66.50246305,33.49753695,tract_part,http://www.prisonersofthecensus.org/data/2010blocks/221190313002025/
2.21E+14,286,0,1,1,4,4,14,310,150,460,67.39130435,32.60869565,tract_part,http://www.prisonersofthecensus.org/data/2010blocks/221190315002238/
2.21E+14,30,0,0,0,0,0,1,31,28,59,52.54237288,47.45762712,tract_part,http://www.prisonersofthecensus.org/data/2010blocks/221190317001044/
2.21E+14,269,2,1,0,4,1,24,301,153,454,66.29955947,33.70044053,tract_part,http://www.prisonersofthecensus.org/data/2010blocks/221210202001046/
2.21E+14,235,1,1,0,7,2,43,289,96,385,75.06493506,24.93506494,tract_part,http://www.prisonersofthecensus.org/data/2010blocks/221230003003091/
2.21E+14,3853,0,0,0,0,31,13,3897,1259,5156,75.58184639,24.41815361,tract_part,http://www.prisonersofthecensus.org/data/2010blocks/221259517012023/
2.21E+14,13,0,0,0,0,0,0,13,11,24,54.16666667,45.83333333,tract_part,http://www.prisonersofthecensus.org/data/2010blocks/221259518003045/
2.21E+14,14,0,0,0,0,0,0,14,33,47,29.78723404,70.21276596,institutionalized,http://www.prisonersofthecensus.org/data/2010blocks/221279603003070/
2.21E+14,15,0,0,0,0,2,2,19,4,23,82.60869565,17.39130435,institutionalized,http://www.prisonersofthecensus.org/data/2010blocks/221279603003075/
2.21E+14,1011,18,2,0,8,22,47,1108,371,1479,74.91548343,25.08451657,tract_part,http://www.prisonersofthecensus.org/data/2010blocks/221279602003017/
2.30E+14,9,0,0,0,0,0,2,11,114,125,8.8,91.2,tract,http://www.prisonersofthecensus.org/data/2010blocks/230010101001005/
2.30E+14,2,0,1,0,0,0,0,3,55,58,5.172413793,94.82758621,tract_part,http://www.prisonersofthecensus.org/data/2010blocks/230039524002022/
2.30E+14,1,0,1,0,0,0,1,3,20,23,13.04347826,86.95652174,institutionalized,http://www.prisonersofthecensus.org/data/2010blocks/230050006001030/
2.30E+14,0,0,0,0,0,0,0,0,25,25,0,100,institutionalized,http://www.prisonersofthecensus.org/data/2010blocks/230050006001033/
2.30E+14,67,0,5,0,0,0,13,85,293,378,22.48677249,77.51322751,tract,http://www.prisonersofthecensus.org/data/2010blocks/230050020021047/
2.30E+14,0,0,0,0,0,0,0,0,2,2,0,100,tract,http://www.prisonersofthecensus.org/data/2010blocks/230050021021007/
2.30E+14,30,8,2,1,2,3,9,55,619,674,8.160237389,91.83976261,tract_part,http://www.prisonersofthecensus.org/data/2010blocks/230050048032050/
2.30E+14,0,0,0,0,0,0,0,0,2,2,0,100,tract_part,http://www.prisonersofthecensus.org/data/2010blocks/230079712002014/
2.30E+14,0,0,0,0,0,0,2,2,52,54,3.703703704,96.2962963,tract,http://www.prisonersofthecensus.org/data/2010blocks/230099655032042/
2.30E+14,6,2,1,0,0,9,4,22,146,168,13.0952381,86.9047619,tract,http://www.prisonersofthecensus.org/data/2010blocks/230110103003023/
2.30E+14,4,1,0,0,0,1,3,9,40,49,18.36734694,81.63265306,tract,http://www.prisonersofthecensus.org/data/2010blocks/230110107001013/
2.30E+14,3,2,0,0,2,0,3,10,65,75,13.33333333,86.66666667,tract,http://www.prisonersofthecensus.org/data/2010blocks/230139706002004/
2.30E+14,55,16,7,0,4,2,9,93,683,776,11.98453608,88.01546392,institutionalized,http://www.prisonersofthecensus.org/data/2010blocks/230139704002070/
2.30E+14,16,3,0,0,10,0,6,35,146,181,19.33701657,80.66298343,institutionalized,http://www.prisonersofthecensus.org/data/2010blocks/230139704002071/
2.30E+14,10,0,0,0,0,0,1,11,148,159,6.918238994,93.08176101,tract_part,http://www.prisonersofthecensus.org/data/2010blocks/230159755004066/
2.30E+14,0,3,0,1,0,0,0,4,22,26,15.38461538,84.61538462,tract,http://www.prisonersofthecensus.org/data/2010blocks/230190003002001/
2.30E+14,10,4,0,0,0,0,3,17,169,186,9.139784946,90.86021505,tract,http://www.prisonersofthecensus.org/data/2010blocks/230190005002012/
2.30E+14,3,2,0,0,0,0,0,5,120,125,4,96,tract_part,http://www.prisonersofthecensus.org/data/2010blocks/230190312001012/
2.30E+14,0,0,0,0,0,0,1,1,23,24,4.166666667,95.83333333,tract_part,http://www.prisonersofthecensus.org/data/2010blocks/230219607003050/
2.30E+14,0,0,0,0,0,0,0,0,2,2,0,100,tract_part,http://www.prisonersofthecensus.org/data/2010blocks/230239703022056/
2.30E+14,6,1,2,0,0,0,0,9,154,163,5.521472393,94.47852761,tract_part,http://www.prisonersofthecensus.org/data/2010blocks/230259665001042/
2.30E+14,1,1,0,0,0,0,0,2,11,13,15.38461538,84.61538462,tract,http://www.prisonersofthecensus.org/data/2010blocks/230270430003054/
2.30E+14,0,9,0,0,0,1,1,11,34,45,24.44444444,75.55555556,tract_part,http://www.prisonersofthecensus.org/data/2010blocks/230299562002023/
2.30E+14,8,7,1,0,2,5,7,30,124,154,19.48051948,80.51948052,tract_part,http://www.prisonersofthecensus.org/data/2010blocks/230299561002059/
2.30E+14,13,5,0,0,0,3,4,25,184,209,11.96172249,88.03827751,tract,http://www.prisonersofthecensus.org/data/2010blocks/230310290002069/
2.40E+14,1217,0,1,0,8,0,13,1239,420,1659,74.6835443,25.3164557,tract_part,http://www.prisonersofthecensus.org/data/2010blocks/240010013002050/
2.40E+14,1171,1,3,1,0,0,6,1182,245,1427,82.83111423,17.16888577,institutionalized,http://www.prisonersofthecensus.org/data/2010blocks/240010013002047/
2.40E+14,32,0,0,0,0,0,1,33,104,137,24.08759124,75.91240876,institutionalized,http://www.prisonersofthecensus.org/data/2010blocks/240010013002070/
2.40E+14,1,0,0,0,0,0,0,1,23,24,4.166666667,95.83333333,tract_part,http://www.prisonersofthecensus.org/data/2010blocks/240010016001087/
2.40E+14,708,0,11,0,6,1,265,991,294,1285,77.12062257,22.87937743,institutionalized,http://www.prisonersofthecensus.org/data/2010blocks/240010002003023/
2.40E+14,141,0,0,0,0,0,65,206,48,254,81.1023622,18.8976378,institutionalized,http://www.prisonersofthecensus.org/data/2010blocks/240010002003051/
2.40E+14,0,0,0,0,0,1,1,2,24,26,7.692307692,92.30769231,tract_part,http://www.prisonersofthecensus.org/data/2010blocks/240010003003002/
2.40E+14,132,0,0,0,1,0,6,139,173,312,44.55128205,55.44871795,tract_part,http://www.prisonersofthecensus.org/data/2010blocks/240037511021009/
2.40E+14,1651,0,7,0,20,2,45,1725,492,2217,77.80784844,22.19215156,institutionalized,http://www.prisonersofthecensus.org/data/2010blocks/240037404001000/
2.40E+14,1346,0,2,0,0,4,20,1372,329,1701,80.65843621,19.34156379,institutionalized,http://www.prisonersofthecensus.org/data/2010blocks/240037404001001/
2.40E+14,478,2,2,0,0,1,6,489,329,818,59.7799511,40.2200489,institutionalized,http://www.prisonersofthecensus.org/data/2010blocks/240037404001005/
2.40E+14,261,1,3,0,14,0,28,307,255,562,54.62633452,45.37366548,tract,http://www.prisonersofthecensus.org/data/2010blocks/240037027011004/
2.40E+14,226,0,0,0,3,5,0,234,144,378,61.9047619,38.0952381,tract,http://www.prisonersofthecensus.org/data/2010blocks/240054925002004/
2.40E+14,9,0,0,0,0,0,1,10,27,37,27.02702703,72.97297297,tract_part,http://www.prisonersofthecensus.org/data/2010blocks/240054042024015/
2.40E+14,653,9,15,0,13,29,58,777,578,1355,57.34317343,42.65682657,tract,http://www.prisonersofthecensus.org/data/2010blocks/240054903013014/
2.40E+14,92,0,1,0,0,1,2,96,165,261,36.7816092,63.2183908,tract_part,http://www.prisonersofthecensus.org/data/2010blocks/240098607011056/
2.40E+14,37,0,0,0,0,0,2,39,62,101,38.61386139,61.38613861,tract_part,http://www.prisonersofthecensus.org/data/2010blocks/240119553023021/
2.40E+14,12,0,0,0,1,0,1,14,6,20,70,30,tract_part,http://www.prisonersofthecensus.org/data/2010blocks/240135052032022/
2.40E+14,371,0,2,0,0,0,1,374,120,494,75.70850202,24.29149798,tract_part,http://www.prisonersofthecensus.org/data/2010blocks/240135052032038/
2.40E+14,33,0,0,0,4,0,10,47,191,238,19.74789916,80.25210084,tract_part,http://www.prisonersofthecensus.org/data/2010blocks/240135076023035/
2.40E+14,41,1,0,0,3,1,6,52,181,233,22.31759657,77.68240343,tract,http://www.prisonersofthecensus.org/data/2010blocks/240150304003007/
2.40E+14,42,0,0,1,0,0,0,43,16,59,72.88135593,27.11864407,tract_part,http://www.prisonersofthecensus.org/data/2010blocks/240150312023068/
2.40E+14,248,1,1,1,0,2,25,278,140,418,66.50717703,33.49282297,tract_part,http://www.prisonersofthecensus.org/data/2010blocks/240178510012037/
2.40E+14,149,0,0,0,1,1,3,154,22,176,87.5,12.5,tract_part,http://www.prisonersofthecensus.org/data/2010blocks/240178513021001/
2.40E+14,3,0,0,0,0,0,0,3,0,3,100,0,tract_part,http://www.prisonersofthecensus.org/data/2010blocks/240199704003025/
2.40E+14,89,0,0,0,6,0,12,107,41,148,72.2972973,27.7027027,tract_part,http://www.prisonersofthecensus.org/data/2010blocks/240199707021082/
2.40E+14,180,1,2,0,15,8,36,242,207,449,53.89755011,46.10244989,tract_part,http://www.prisonersofthecensus.org/data/2010blocks/240217510031052/
2.40E+14,0,0,0,0,1,1,2,4,40,44,9.090909091,90.90909091,tract_part,http://www.prisonersofthecensus.org/data/2010blocks/240230006003033/
2.40E+14,139,0,1,0,0,1,7,148,249,397,37.27959698,62.72040302,tract_part,http://www.prisonersofthecensus.org/data/2010blocks/240253038021008/
2.40E+14,603,0,2,0,1,1,6,613,197,810,75.67901235,24.32098765,institutionalized,http://www.prisonersofthecensus.org/data/2010blocks/240276012032039/
2.40E+14,125,0,2,0,0,1,12,140,107,247,56.68016194,43.31983806,institutionalized,http://www.prisonersofthecensus.org/data/2010blocks/240276012032056/
2.40E+14,0,0,0,0,0,0,0,0,2,2,0,100,tract,http://www.prisonersofthecensus.org/data/2010blocks/240276056014000/
2.40E+14,5,0,0,0,0,0,0,5,5,10,50,50,tract_part,http://www.prisonersofthecensus.org/data/2010blocks/240276069012057/
2.40E+14,35,0,0,0,0,0,4,39,38,77,50.64935065,49.35064935,tract_part,http://www.prisonersofthecensus.org/data/2010blocks/240299503001078/
2.40E+14,419,0,9,0,0,0,133,561,192,753,74.50199203,25.49800797,tract_part,http://www.prisonersofthecensus.org/data/2010blocks/240317003121011/
2.40E+14,75,0,7,0,4,0,19,105,48,153,68.62745098,31.37254902,tract,http://www.prisonersofthecensus.org/data/2010blocks/240317012163000/
2.40E+14,82,0,2,0,2,0,37,123,40,163,75.4601227,24.5398773,tract_part,http://www.prisonersofthecensus.org/data/2010blocks/240317010021002/
2.40E+14,1,0,0,0,0,1,0,2,0,2,100,0,tract_part,http://www.prisonersofthecensus.org/data/2010blocks/240338006071000/
2.40E+14,0,0,0,0,0,0,0,0,1,1,0,100,tract,http://www.prisonersofthecensus.org/data/2010blocks/240338011043055/
2.40E+14,5,0,0,0,0,0,0,5,0,5,100,0,tract_part,http://www.prisonersofthecensus.org/data/2010blocks/240338017012010/
2.40E+14,7,0,0,0,0,0,0,7,0,7,100,0,tract_part,http://www.prisonersofthecensus.org/data/2010blocks/240338004122008/
2.40E+14,902,16,6,1,94,48,145,1212,55,1267,95.6590371,4.340962904,tract_part,http://www.prisonersofthecensus.org/data/2010blocks/240338006052000/
2.40E+14,108,0,0,0,0,0,3,111,57,168,66.07142857,33.92857143,tract_part,http://www.prisonersofthecensus.org/data/2010blocks/240358103002038/
2.40E+14,23,1,0,0,3,4,6,37,56,93,39.78494624,60.21505376,tract_part,http://www.prisonersofthecensus.org/data/2010blocks/240358104002048/
2.40E+14,104,3,0,0,1,3,2,113,139,252,44.84126984,55.15873016,tract_part,http://www.prisonersofthecensus.org/data/2010blocks/240378755002052/
2.40E+14,2399,1,2,0,2,6,28,2438,811,3249,75.03847338,24.96152662,institutionalized,http://www.prisonersofthecensus.org/data/2010blocks/240399804001008/
2.40E+14,50,1,1,0,0,0,1,53,31,84,63.0952381,36.9047619,institutionalized,http://www.prisonersofthecensus.org/data/2010blocks/240399804001044/
2.40E+14,49,1,0,0,4,1,6,61,43,104,58.65384615,41.34615385,tract_part,http://www.prisonersofthecensus.org/data/2010blocks/240419603001068/
2.40E+14,149,0,0,0,0,1,0,150,56,206,72.81553398,27.18446602,institutionalized,http://www.prisonersofthecensus.org/data/2010blocks/240430110001000/
2.40E+14,1185,1,1,0,1,8,11,1207,472,1679,71.88802859,28.11197141,institutionalized,http://www.prisonersofthecensus.org/data/2010blocks/240430110001003/
2.40E+14,1695,2,6,0,11,11,213,1938,595,2533,76.51006711,23.48993289,institutionalized,http://www.prisonersofthecensus.org/data/2010blocks/240430110003001/
2.40E+14,1295,1,6,1,5,3,13,1324,424,1748,75.74370709,24.25629291,institutionalized,http://www.prisonersofthecensus.org/data/2010blocks/240430110003002/
2.40E+14,0,0,0,0,0,0,2,2,8,10,20,80,tract,http://www.prisonersofthecensus.org/data/2010blocks/240430007001010/
2.40E+14,158,0,0,0,0,0,2,160,264,424,37.73584906,62.26415094,tract_part,http://www.prisonersofthecensus.org/data/2010blocks/240430009002038/
2.40E+14,80,0,0,0,0,0,1,81,41,122,66.39344262,33.60655738,tract_part,http://www.prisonersofthecensus.org/data/2010blocks/240450108003022/
2.40E+14,282,0,0,0,32,0,35,349,192,541,64.51016636,35.48983364,tract_part,http://www.prisonersofthecensus.org/data/2010blocks/240450107026114/
2.40E+14,140,0,6,0,12,6,35,199,144,343,58.01749271,41.98250729,tract_part,http://www.prisonersofthecensus.org/data/2010blocks/240479513002074/
2.45E+14,4,0,0,0,0,0,0,4,3,7,57.14285714,42.85714286,tract,http://www.prisonersofthecensus.org/data/2010blocks/245100302001001/
2.45E+14,614,0,0,0,0,1,2,617,173,790,78.10126582,21.89873418,institutionalized,http://www.prisonersofthecensus.org/data/2010blocks/245101003001000/
2.45E+14,2890,0,3,2,27,3,35,2960,433,3393,87.23843207,12.76156793,institutionalized,http://www.prisonersofthecensus.org/data/2010blocks/245101003001001/
2.45E+14,405,0,0,0,0,0,11,416,76,492,84.55284553,15.44715447,institutionalized,http://www.prisonersofthecensus.org/data/2010blocks/245101003001007/
2.45E+14,26,0,0,0,0,1,0,27,3,30,90,10,tract,http://www.prisonersofthecensus.org/data/2010blocks/245101205001017/
2.45E+14,5,0,0,0,0,0,0,5,0,5,100,0,tract,http://www.prisonersofthecensus.org/data/2010blocks/245101508004000/
2.45E+14,12,0,0,0,0,1,1,14,1,15,93.33333333,6.666666667,tract,http://www.prisonersofthecensus.org/data/2010blocks/245101701001020/
2.45E+14,31,0,0,0,1,1,1,34,6,40,85,15,tract,http://www.prisonersofthecensus.org/data/2010blocks/245101903001013/
2.45E+14,1006,0,1,1,11,6,76,1101,138,1239,88.86198547,11.13801453,tract,http://www.prisonersofthecensus.org/data/2010blocks/245102805002024/
2.50E+14,74,5,2,0,18,1,26,126,327,453,27.81456954,72.18543046,tract_part,http://www.prisonersofthecensus.org/data/2010blocks/250010141001188/
2.50E+14,93,1,1,0,13,2,22,132,234,366,36.06557377,63.93442623,tract,http://www.prisonersofthecensus.org/data/2010blocks/250039011004013/
2.50E+14,271,9,15,1,65,35,201,597,596,1193,50.04191115,49.95808885,tract,http://www.prisonersofthecensus.org/data/2010blocks/250056531022022/
2.50E+14,45,1,0,0,15,3,38,102,94,196,52.04081633,47.95918367,tract,http://www.prisonersofthecensus.org/data/2010blocks/250056517002007/
2.50E+14,7,0,0,0,0,1,3,11,20,31,35.48387097,64.51612903,tract,http://www.prisonersofthecensus.org/data/2010blocks/250072003003039/
2.50E+14,24,0,0,0,7,1,45,77,148,225,34.22222222,65.77777778,tract,http://www.prisonersofthecensus.org/data/2010blocks/250092508003005/
2.50E+14,159,37,19,3,257,57,495,1027,525,1552,66.17268041,33.82731959,tract,http://www.prisonersofthecensus.org/data/2010blocks/250092121004009/
2.50E+14,2,0,0,0,0,0,1,3,17,20,15,85,tract_part,http://www.prisonersofthecensus.org/data/2010blocks/250092671023039/
2.50E+14,23,3,2,0,7,4,28,67,121,188,35.63829787,64.36170213,tract,http://www.prisonersofthecensus.org/data/2010blocks/250110414001000/
2.50E+14,19,0,2,0,5,1,28,55,62,117,47.00854701,52.99145299,tract,http://www.prisonersofthecensus.org/data/2010blocks/250138109023044/
2.50E+14,309,3,3,0,55,7,515,892,247,1139,78.3143108,21.6856892,institutionalized,http://www.prisonersofthecensus.org/data/2010blocks/250138104141007/
2.50E+14,42,1,0,0,21,2,64,130,53,183,71.03825137,28.96174863,institutionalized,http://www.prisonersofthecensus.org/data/2010blocks/250138104141016/
2.50E+14,19,0,0,0,9,2,24,54,119,173,31.21387283,68.78612717,tract,http://www.prisonersofthecensus.org/data/2010blocks/250138011022000/
2.50E+14,6,0,0,0,0,0,18,24,22,46,52.17391304,47.82608696,tract,http://www.prisonersofthecensus.org/data/2010blocks/250138019012020/
2.50E+14,0,0,0,0,0,0,0,0,1,1,0,100,tract,http://www.prisonersofthecensus.org/data/2010blocks/250158224024002/
2.50E+14,37,5,4,0,50,5,63,164,137,301,54.48504983,45.51495017,tract,http://www.prisonersofthecensus.org/data/2010blocks/250158219032001/
2.50E+14,0,0,1,0,0,0,0,1,1,2,50,50,tract,http://www.prisonersofthecensus.org/data/2010blocks/250173567024017/
2.50E+14,216,9,5,0,7,0,117,354,452,806,43.92059553,56.07940447,tract,http://www.prisonersofthecensus.org/data/2010blocks/250173164006001/
2.50E+14,3,0,3,0,0,0,0,6,0,6,100,0,tract,http://www.prisonersofthecensus.org/data/2010blocks/250173539003008/
2.50E+14,1,0,1,0,0,0,4,6,6,12,50,50,tract,http://www.prisonersofthecensus.org/data/2010blocks/250173173011006/
2.50E+14,441,1,7,0,76,11,291,827,393,1220,67.78688525,32.21311475,tract_part,http://www.prisonersofthecensus.org/data/2010blocks/250173612001003/
2.50E+14,70,1,0,0,27,2,97,197,110,307,64.16938111,35.83061889,tract,http://www.prisonersofthecensus.org/data/2010blocks/250173613004044/
2.50E+14,135,4,5,12,34,6,122,318,494,812,39.16256158,60.83743842,tract,http://www.prisonersofthecensus.org/data/2010blocks/250173831011014/
2.50E+14,434,0,23,0,27,0,378,862,622,1484,58.08625337,41.91374663,tract_part,http://www.prisonersofthecensus.org/data/2010blocks/250173882003086/
2.50E+14,150,0,5,0,4,0,103,262,355,617,42.46353323,57.53646677,tract,http://www.prisonersofthecensus.org/data/2010blocks/250214025002016/
2.50E+14,448,14,46,0,108,8,457,1081,566,1647,65.63448695,34.36551305,institutionalized,http://www.prisonersofthecensus.org/data/2010blocks/250214091013017/
2.50E+14,90,2,5,0,24,2,97,220,137,357,61.62464986,38.37535014,institutionalized,http://www.prisonersofthecensus.org/data/2010blocks/250214091013029/
2.50E+14,46,2,0,0,19,1,66,134,74,208,64.42307692,35.57692308,institutionalized,http://www.prisonersofthecensus.org/data/2010blocks/250214091013042/
2.50E+14,75,3,1,0,20,1,84,184,92,276,66.66666667,33.33333333,institutionalized,http://www.prisonersofthecensus.org/data/2010blocks/250214091013048/
2.50E+14,149,2,7,0,36,6,165,365,167,532,68.60902256,31.39097744,tract_part,http://www.prisonersofthecensus.org/data/2010blocks/250214113022021/
2.50E+14,12,0,0,0,0,1,1,14,266,280,5,95,tract,http://www.prisonersofthecensus.org/data/2010blocks/250214412041053/
2.50E+14,306,8,6,0,24,3,193,540,370,910,59.34065934,40.65934066,institutionalized,http://www.prisonersofthecensus.org/data/2010blocks/250235253001016/
2.50E+14,29,0,0,0,6,1,18,54,124,178,30.33707865,69.66292135,institutionalized,http://www.prisonersofthecensus.org/data/2010blocks/250235253001019/
2.50E+14,218,17,10,0,39,7,135,426,635,1061,40.15080113,59.84919887,institutionalized,http://www.prisonersofthecensus.org/data/2010blocks/250235253001026/
2.50E+14,1,0,0,0,1,0,1,3,4,7,42.85714286,57.14285714,tract,http://www.prisonersofthecensus.org/data/2010blocks/250235110002021/
2.50E+14,260,21,6,0,44,0,139,470,860,1330,35.33834586,64.66165414,institutionalized,http://www.prisonersofthecensus.org/data/2010blocks/250235306001021/
2.50E+14,61,3,0,0,11,9,44,128,86,214,59.81308411,40.18691589,institutionalized,http://www.prisonersofthecensus.org/data/2010blocks/250235306004046/
2.50E+14,0,0,0,0,0,0,0,0,1,1,0,100,tract,http://www.prisonersofthecensus.org/data/2010blocks/250250101031007/
2.50E+14,29,1,0,0,17,1,20,68,12,80,85,15,tract,http://www.prisonersofthecensus.org/data/2010blocks/250250102033003/
2.50E+14,30,0,2,0,11,3,16,62,30,92,67.39130435,32.60869565,tract,http://www.prisonersofthecensus.org/data/2010blocks/250250104042000/
2.50E+14,405,1,4,0,0,0,179,589,138,727,81.01788171,18.98211829,tract,http://www.prisonersofthecensus.org/data/2010blocks/250250203032013/
2.50E+14,0,0,0,0,0,0,0,0,1,1,0,100,tract,http://www.prisonersofthecensus.org/data/2010blocks/250250701013008/
2.50E+14,4,2,1,0,3,1,6,17,10,27,62.96296296,37.03703704,tract,http://www.prisonersofthecensus.org/data/2010blocks/250250711013002/
2.50E+14,708,2,27,0,2,1,458,1198,317,1515,79.07590759,20.92409241,tract,http://www.prisonersofthecensus.org/data/2010blocks/250250801001002/
2.50E+14,10,0,0,0,2,0,7,19,8,27,70.37037037,29.62962963,tract,http://www.prisonersofthecensus.org/data/2010blocks/250259803001025/
2.50E+14,72,0,2,0,18,0,59,151,66,217,69.58525346,30.41474654,tract,http://www.prisonersofthecensus.org/data/2010blocks/250259811004004/
2.50E+14,62,0,0,0,0,0,33,95,185,280,33.92857143,66.07142857,tract,http://www.prisonersofthecensus.org/data/2010blocks/250277108001008/
2.50E+14,221,14,2,0,46,4,290,577,506,1083,53.27793167,46.72206833,tract,http://www.prisonersofthecensus.org/data/2010blocks/250277075002027/
2.50E+14,230,0,4,0,10,2,134,380,826,1206,31.50912106,68.49087894,tract_part,http://www.prisonersofthecensus.org/data/2010blocks/250277614006154/
2.50E+14,224,0,4,0,9,1,250,488,782,1270,38.42519685,61.57480315,tract_part,http://www.prisonersofthecensus.org/data/2010blocks/250277131004001/
2.50E+14,3,0,0,0,0,0,4,7,6,13,53.84615385,46.15384615,tract,http://www.prisonersofthecensus.org/data/2010blocks/250277612003032/
2.50E+14,253,13,0,0,35,0,283,584,590,1174,49.74446337,50.25553663,tract,http://www.prisonersofthecensus.org/data/2010blocks/250277291001048/
2.60E+14,0,1,0,0,0,0,0,1,27,28,3.571428571,96.42857143,tract_part,http://www.prisonersofthecensus.org/data/2010blocks/260019701002076/
2.60E+14,0,3,0,0,0,1,3,7,10,17,41.17647059,58.82352941,tract_part,http://www.prisonersofthecensus.org/data/2010blocks/260030002002168/
2.60E+14,593,4,2,0,0,0,8,607,241,848,71.58018868,28.41981132,tract_part,http://www.prisonersofthecensus.org/data/2010blocks/260030003002013/
2.60E+14,15,2,0,0,0,0,14,31,128,159,19.49685535,80.50314465,tract_part,http://www.prisonersofthecensus.org/data/2010blocks/260050312001037/
2.60E+14,0,0,0,0,0,0,0,0,4,4,0,100,tract_part,http://www.prisonersofthecensus.org/data/2010blocks/260050305002023/
2.60E+14,2,1,0,1,0,2,4,10,47,57,17.54385965,82.45614035,tract_part,http://www.prisonersofthecensus.org/data/2010blocks/260070003004082/
2.60E+14,0,4,0,0,0,1,1,6,36,42,14.28571429,85.71428571,tract_part,http://www.prisonersofthecensus.org/data/2010blocks/260099604001096/
2.60E+14,1,1,0,0,0,0,0,2,41,43,4.651162791,95.34883721,tract_part,http://www.prisonersofthecensus.org/data/2010blocks/260119705003033/
2.60E+14,600,4,2,0,0,0,7,613,240,853,71.86400938,28.13599062,tract_part,http://www.prisonersofthecensus.org/data/2010blocks/260130002003066/
2.60E+14,14,1,0,0,0,0,0,15,5,20,75,25,tract_part,http://www.prisonersofthecensus.org/data/2010blocks/260130001004042/
2.60E+14,8,1,0,0,0,2,2,13,67,80,16.25,83.75,tract_part,http://www.prisonersofthecensus.org/data/2010blocks/260150114003040/
2.60E+14,0,0,0,0,0,0,2,2,1,3,66.66666667,33.33333333,tract,http://www.prisonersofthecensus.org/data/2010blocks/260172858004025/
2.60E+14,42,4,1,0,0,2,24,73,109,182,40.10989011,59.89010989,tract,http://www.prisonersofthecensus.org/data/2010blocks/260172865001062/
2.60E+14,0,1,0,0,0,0,5,6,44,50,12,88,tract_part,http://www.prisonersofthecensus.org/data/2010blocks/260190003002087/
2.60E+14,28,1,0,0,0,4,3,36,48,84,42.85714286,57.14285714,tract_part,http://www.prisonersofthecensus.org/data/2010blocks/260210003002001/
2.60E+14,214,1,0,0,1,2,9,227,186,413,54.96368039,45.03631961,tract_part,http://www.prisonersofthecensus.org/data/2010blocks/260210008001006/
2.60E+14,414,6,2,0,0,1,46,469,747,1216,38.56907895,61.43092105,institutionalized,http://www.prisonersofthecensus.org/data/2010blocks/260239513003002/
2.60E+14,130,1,0,0,0,0,6,137,94,231,59.30735931,40.69264069,institutionalized,http://www.prisonersofthecensus.org/data/2010blocks/260239513003007/
2.60E+14,629,9,3,0,0,1,27,669,516,1185,56.4556962,43.5443038,institutionalized,http://www.prisonersofthecensus.org/data/2010blocks/260239513003008/
2.60E+14,3,0,1,0,0,2,3,9,97,106,8.490566038,91.50943396,institutionalized,http://www.prisonersofthecensus.org/data/2010blocks/260239513004003/
2.60E+14,211,2,23,0,8,5,94,343,244,587,58.43270869,41.56729131,tract_part,http://www.prisonersofthecensus.org/data/2010blocks/260250007001067/
2.60E+14,14,0,0,0,0,0,4,18,35,53,33.96226415,66.03773585,tract_part,http://www.prisonersofthecensus.org/data/2010blocks/260250022003011/
2.60E+14,32,0,0,0,0,2,4,38,76,114,33.33333333,66.66666667,tract_part,http://www.prisonersofthecensus.org/data/2010blocks/260270021003001/
2.60E+14,1,2,0,0,0,0,0,3,48,51,5.882352941,94.11764706,tract_part,http://www.prisonersofthecensus.org/data/2010blocks/260290015002038/
2.60E+14,25,0,0,0,0,0,7,32,45,77,41.55844156,58.44155844,tract_part,http://www.prisonersofthecensus.org/data/2010blocks/260319603003002/
2.60E+14,1022,19,10,0,0,1,21,1073,781,1854,57.87486516,42.12513484,tract_part,http://www.prisonersofthecensus.org/data/2010blocks/260339709001077/
2.60E+14,1322,23,6,1,2,3,32,1389,838,2227,62.37090256,37.62909744,tract,http://www.prisonersofthecensus.org/data/2010blocks/260339802001000/
2.60E+14,2,19,6,0,1,21,3,52,60,112,46.42857143,53.57142857,tract,http://www.prisonersofthecensus.org/data/2010blocks/260339703004054/
2.60E+14,26,6,0,0,0,0,2,34,80,114,29.8245614,70.1754386,tract_part,http://www.prisonersofthecensus.org/data/2010blocks/260350013001002/
2.60E+14,67,1,1,0,3,5,13,90,92,182,49.45054945,50.54945055,tract_part,http://www.prisonersofthecensus.org/data/2010blocks/260370109012043/
2.60E+14,1,0,0,0,0,0,0,1,37,38,2.631578947,97.36842105,tract_part,http://www.prisonersofthecensus.org/data/2010blocks/260399602002218/
2.60E+14,4,8,0,0,0,0,0,12,69,81,14.81481481,85.18518519,tract_part,http://www.prisonersofthecensus.org/data/2010blocks/260419709001005/
2.60E+14,2,1,0,0,0,0,0,3,73,76,3.947368421,96.05263158,tract_part,http://www.prisonersofthecensus.org/data/2010blocks/260439504002069/
2.60E+14,39,0,0,0,0,0,5,44,163,207,21.25603865,78.74396135,tract_part,http://www.prisonersofthecensus.org/data/2010blocks/260450210013018/
2.60E+14,2,5,0,0,0,1,0,8,68,76,10.52631579,89.47368421,tract_part,http://www.prisonersofthecensus.org/data/2010blocks/260479707001095/
2.60E+14,12,0,0,0,0,0,0,12,22,34,35.29411765,64.70588235,tract,http://www.prisonersofthecensus.org/data/2010blocks/260490014003030/
2.60E+14,365,0,0,0,5,1,14,385,268,653,58.95865237,41.04134763,tract,http://www.prisonersofthecensus.org/data/2010blocks/260490028001002/
2.60E+14,54,0,0,0,0,0,1,55,74,129,42.63565891,57.36434109,tract,http://www.prisonersofthecensus.org/data/2010blocks/260490136001004/
2.61E+14,2,1,0,0,0,0,0,3,63,66,4.545454545,95.45454545,tract_part,http://www.prisonersofthecensus.org/data/2010blocks/260510007004005/
2.61E+14,3,0,0,0,0,0,0,3,20,23,13.04347826,86.95652174,tract_part,http://www.prisonersofthecensus.org/data/2010blocks/260539503001038/
2.61E+14,631,5,1,0,0,0,4,641,519,1160,55.25862069,44.74137931,tract_part,http://www.prisonersofthecensus.org/data/2010blocks/260539501003041/
2.61E+14,636,8,6,0,0,1,74,725,611,1336,54.26646707,45.73353293,tract_part,http://www.prisonersofthecensus.org/data/2010blocks/260555503001172/
2.61E+14,4,12,0,0,1,2,5,24,138,162,14.81481481,85.18518519,tract_part,http://www.prisonersofthecensus.org/data/2010blocks/260555512001036/
2.61E+14,7,4,0,0,1,1,5,18,43,61,29.50819672,70.49180328,tract_part,http://www.prisonersofthecensus.org/data/2010blocks/260570010004008/
2.61E+14,761,12,3,0,0,1,14,791,480,1271,62.23446105,37.76553895,tract_part,http://www.prisonersofthecensus.org/data/2010blocks/260570003001020/
2.61E+14,1399,19,1,0,0,3,23,1445,967,2412,59.90878939,40.09121061,tract,http://www.prisonersofthecensus.org/data/2010blocks/260570004001001/
2.61E+14,1,0,0,0,0,0,1,2,62,64,3.125,96.875,tract_part,http://www.prisonersofthecensus.org/data/2010blocks/260590507001008/
2.61E+14,3,0,0,0,0,1,0,4,24,28,14.28571429,85.71428571,tract_part,http://www.prisonersofthecensus.org/data/2010blocks/260610008004023/
2.61E+14,12,0,0,0,1,0,2,15,40,55,27.27272727,72.72727273,tract_part,http://www.prisonersofthecensus.org/data/2010blocks/260639510004002/
2.61E+14,352,2,0,0,3,5,36,398,283,681,58.44346549,41.55653451,tract_part,http://www.prisonersofthecensus.org/data/2010blocks/260650063011008/
2.61E+14,10,1,0,0,3,0,5,19,96,115,16.52173913,83.47826087,tract_part,http://www.prisonersofthecensus.org/data/2010blocks/260670317003028/
2.61E+14,869,9,4,0,0,2,81,965,325,1290,74.80620155,25.19379845,tract_part,http://www.prisonersofthecensus.org/data/2010blocks/260670321002077/
2.61E+14,392,4,3,0,1,1,43,444,219,663,66.96832579,33.03167421,institutionalized,http://www.prisonersofthecensus.org/data/2010blocks/260679822001000/
2.61E+14,635,3,2,0,0,4,92,736,530,1266,58.13586098,41.86413902,institutionalized,http://www.prisonersofthecensus.org/data/2010blocks/260679822001002/
2.61E+14,896,20,8,0,0,2,126,1052,812,1864,56.43776824,43.56223176,institutionalized,http://www.prisonersofthecensus.org/data/2010blocks/260679822001007/
2.61E+14,0,0,0,0,0,0,0,0,1,1,0,100,tract_part,http://www.prisonersofthecensus.org/data/2010blocks/260690004001043/
2.61E+14,0,3,0,0,0,0,0,3,10,13,23.07692308,76.92307692,tract_part,http://www.prisonersofthecensus.org/data/2010blocks/260690002002116/
2.61E+14,3,0,1,0,0,1,0,5,65,70,7.142857143,92.85714286,tract_part,http://www.prisonersofthecensus.org/data/2010blocks/260690005002010/
2.61E+14,0,2,0,0,0,0,0,2,24,26,7.692307692,92.30769231,tract_part,http://www.prisonersofthecensus.org/data/2010blocks/260710005002044/
2.61E+14,14,26,0,0,3,4,9,56,106,162,34.56790123,65.43209877,tract_part,http://www.prisonersofthecensus.org/data/2010blocks/260739404002074/
2.61E+14,1334,29,3,0,0,5,122,1493,1623,3116,47.9139923,52.0860077,institutionalized,http://www.prisonersofthecensus.org/data/2010blocks/260750058001000/
2.61E+14,800,13,2,0,0,3,43,861,860,1721,50.02905288,49.97094712,institutionalized,http://www.prisonersofthecensus.org/data/2010blocks/260750058001002/
2.61E+14,919,24,3,0,0,1,107,1054,901,1955,53.91304348,46.08695652,institutionalized,http://www.prisonersofthecensus.org/data/2010blocks/260750058001003/
2.61E+14,84,0,1,0,4,0,4,93,141,234,39.74358974,60.25641026,tract_part,http://www.prisonersofthecensus.org/data/2010blocks/260750059002005/
2.61E+14,72,0,0,0,0,0,1,73,105,178,41.01123596,58.98876404,tract,http://www.prisonersofthecensus.org/data/2010blocks/260750006001047/
2.61E+14,16,0,0,0,0,0,1,17,14,31,54.83870968,45.16129032,tract,http://www.prisonersofthecensus.org/data/2010blocks/260770002011093/
2.61E+14,149,0,1,0,6,4,22,182,118,300,60.66666667,39.33333333,tract,http://www.prisonersofthecensus.org/data/2010blocks/260770018011003/
2.61E+14,17,0,0,0,2,2,2,23,27,50,46,54,tract_part,http://www.prisonersofthecensus.org/data/2010blocks/260770018031099/
2.61E+14,1,1,0,0,0,0,1,3,52,55,5.454545455,94.54545455,tract_part,http://www.prisonersofthecensus.org/data/2010blocks/260799503002020/
2.61E+14,489,8,4,0,0,0,98,599,409,1008,59.42460317,40.57539683,tract,http://www.prisonersofthecensus.org/data/2010blocks/260810011013014/
2.61E+14,0,0,0,0,0,0,0,0,2,2,0,100,tract,http://www.prisonersofthecensus.org/data/2010blocks/260810025004005/
2.61E+14,29,2,0,0,0,0,3,34,15,49,69.3877551,30.6122449,tract,http://www.prisonersofthecensus.org/data/2010blocks/260810031001003/
2.61E+14,31,0,0,0,0,0,3,34,27,61,55.73770492,44.26229508,tract,http://www.prisonersofthecensus.org/data/2010blocks/260810038001008/
2.61E+14,18,0,0,0,0,0,5,23,21,44,52.27272727,47.72727273,tract,http://www.prisonersofthecensus.org/data/2010blocks/260810101022070/
2.61E+14,0,0,0,0,0,0,0,0,4,4,0,100,tract_part,http://www.prisonersofthecensus.org/data/2010blocks/260830001002051/
2.61E+14,5,0,0,0,0,1,0,6,14,20,30,70,tract_part,http://www.prisonersofthecensus.org/data/2010blocks/260859612002084/
2.61E+14,111,7,1,0,2,19,16,156,127,283,55.12367491,44.87632509,tract_part,http://www.prisonersofthecensus.org/data/2010blocks/260859612002079/
2.61E+14,615,7,4,0,3,1,23,653,303,956,68.30543933,31.69456067,tract,http://www.prisonersofthecensus.org/data/2010blocks/260873365001001/
2.61E+14,4,0,0,0,0,0,3,7,103,110,6.363636364,93.63636364,tract_part,http://www.prisonersofthecensus.org/data/2010blocks/260873370004017/
2.61E+14,1,5,0,0,0,0,4,10,18,28,35.71428571,64.28571429,tract_part,http://www.prisonersofthecensus.org/data/2010blocks/260899702001169/
2.61E+14,29,2,3,1,13,5,38,91,136,227,40.08810573,59.91189427,tract_part,http://www.prisonersofthecensus.org/data/2010blocks/260910614001052/
2.61E+14,1108,23,4,0,0,4,19,1158,1177,2335,49.59314775,50.40685225,tract_part,http://www.prisonersofthecensus.org/data/2010blocks/260910617005000/
2.61E+14,55,1,1,0,0,0,1,58,44,102,56.8627451,43.1372549,tract,http://www.prisonersofthecensus.org/data/2010blocks/260937446002028/
2.61E+14,9,1,1,0,1,1,4,17,192,209,8.133971292,91.86602871,tract_part,http://www.prisonersofthecensus.org/data/2010blocks/260937251003014/
2.61E+14,725,7,4,0,0,1,21,758,345,1103,68.72166818,31.27833182,tract_part,http://www.prisonersofthecensus.org/data/2010blocks/260959601001001/
2.61E+14,0,0,0,0,0,0,0,0,12,12,0,100,tract_part,http://www.prisonersofthecensus.org/data/2010blocks/260979505002017/
2.61E+14,620,12,6,0,1,0,61,700,570,1270,55.11811024,44.88188976,tract_part,http://www.prisonersofthecensus.org/data/2010blocks/260992180003034/
2.61E+14,400,0,3,0,1,3,6,413,728,1141,36.19631902,63.80368098,tract,http://www.prisonersofthecensus.org/data/2010blocks/260992452002000/
2.61E+14,2,2,0,0,0,1,2,7,39,46,15.2173913,84.7826087,tract_part,http://www.prisonersofthecensus.org/data/2010blocks/261010004002073/
2.61E+14,656,8,1,0,0,2,15,682,365,1047,65.13849093,34.86150907,tract_part,http://www.prisonersofthecensus.org/data/2010blocks/261010005003070/
2.61E+14,13,9,0,0,0,3,0,25,82,107,23.36448598,76.63551402,tract,http://www.prisonersofthecensus.org/data/2010blocks/261030003002022/
2.61E+14,726,8,3,0,1,0,13,751,481,1232,60.95779221,39.04220779,tract_part,http://www.prisonersofthecensus.org/data/2010blocks/261030028003024/
2.61E+14,9,1,0,0,0,0,1,11,48,59,18.6440678,81.3559322,tract_part,http://www.prisonersofthecensus.org/data/2010blocks/261059504004013/
2.61E+14,14,2,0,0,0,1,6,23,52,75,30.66666667,69.33333333,tract_part,http://www.prisonersofthecensus.org/data/2010blocks/261079606001007/
2.61E+14,1,4,0,0,0,0,0,5,20,25,20,80,tract_part,http://www.prisonersofthecensus.org/data/2010blocks/261099607003009/
2.61E+14,7,1,0,0,3,0,3,14,106,120,11.66666667,88.33333333,tract_part,http://www.prisonersofthecensus.org/data/2010blocks/261112906002001/
2.61E+14,1,0,0,0,0,0,1,2,38,40,5,95,tract_part,http://www.prisonersofthecensus.org/data/2010blocks/261139602001057/
2.61E+14,1,0,0,0,1,0,1,3,10,13,23.07692308,76.92307692,tract,http://www.prisonersofthecensus.org/data/2010blocks/261158321002010/
2.61E+14,13,0,0,0,25,2,74,114,65,179,63.68715084,36.31284916,tract_part,http://www.prisonersofthecensus.org/data/2010blocks/261158318001032/
2.61E+14,5,0,0,0,0,0,2,7,22,29,24.13793103,75.86206897,tract_part,http://www.prisonersofthecensus.org/data/2010blocks/261158324001001/
2.61E+14,1240,16,4,0,1,1,35,1297,1196,2493,52.02567188,47.97432812,tract_part,http://www.prisonersofthecensus.org/data/2010blocks/261179710003019/
2.61E+14,25,1,2,0,0,0,21,49,132,181,27.0718232,72.9281768,tract_part,http://www.prisonersofthecensus.org/data/2010blocks/261179708002001/
2.61E+14,0,0,0,0,0,0,0,0,28,28,0,100,tract_part,http://www.prisonersofthecensus.org/data/2010blocks/261199102002063/
2.61E+14,1879,21,11,0,0,3,181,2095,1559,3654,57.33442802,42.66557198,tract_part,http://www.prisonersofthecensus.org/data/2010blocks/261210004022000/
2.61E+14,192,7,0,0,3,21,31,254,160,414,61.352657,38.647343,tract,http://www.prisonersofthecensus.org/data/2010blocks/261210042003006/
2.61E+14,11,2,1,0,1,2,3,20,44,64,31.25,68.75,tract_part,http://www.prisonersofthecensus.org/data/2010blocks/261210004023073/
2.61E+14,0,0,0,0,0,0,11,11,0,11,100,0,tract_part,http://www.prisonersofthecensus.org/data/2010blocks/261239710002045/
2.61E+14,48,4,0,0,23,8,41,124,96,220,56.36363636,43.63636364,tract_part,http://www.prisonersofthecensus.org/data/2010blocks/261239707002066/
2.61E+14,75,3,0,0,3,3,9,93,91,184,50.54347826,49.45652174,tract,http://www.prisonersofthecensus.org/data/2010blocks/261251403021011/
2.61E+14,534,11,9,0,18,34,63,669,485,1154,57.97227036,42.02772964,institutionalized,http://www.prisonersofthecensus.org/data/2010blocks/261251409003008/
2.61E+14,119,3,4,0,2,8,17,153,189,342,44.73684211,55.26315789,institutionalized,http://www.prisonersofthecensus.org/data/2010blocks/261251409003009/
2.61E+14,1,0,0,0,0,0,2,3,10,13,23.07692308,76.92307692,tract,http://www.prisonersofthecensus.org/data/2010blocks/261251417002020/
2.61E+14,3,0,0,0,0,0,0,3,11,14,21.42857143,78.57142857,tract,http://www.prisonersofthecensus.org/data/2010blocks/261251421002007/
2.61E+14,0,0,0,0,0,0,0,0,3,3,0,100,tract,http://www.prisonersofthecensus.org/data/2010blocks/261251836002006/
2.61E+14,0,0,0,0,0,0,0,0,2,2,0,100,tract,http://www.prisonersofthecensus.org/data/2010blocks/261251618002014/
2.61E+14,1,1,0,0,2,0,6,10,41,51,19.60784314,80.39215686,tract_part,http://www.prisonersofthecensus.org/data/2010blocks/261270104003029/
2.61E+14,1,0,0,0,0,0,1,2,30,32,6.25,93.75,tract_part,http://www.prisonersofthecensus.org/data/2010blocks/261299505003013/
2.61E+14,0,0,0,0,0,0,0,0,6,6,0,100,tract_part,http://www.prisonersofthecensus.org/data/2010blocks/261319702003033/
2.61E+14,5,0,0,0,0,1,0,6,72,78,7.692307692,92.30769231,tract_part,http://www.prisonersofthecensus.org/data/2010blocks/261339706002019/
2.61E+14,0,0,0,0,0,0,0,0,4,4,0,100,tract_part,http://www.prisonersofthecensus.org/data/2010blocks/261339702002049/
2.61E+14,0,0,1,0,0,0,2,3,30,33,9.090909091,90.90909091,tract_part,http://www.prisonersofthecensus.org/data/2010blocks/261379503003032/
2.61E+14,3,0,0,0,0,0,1,4,6,10,40,60,tract_part,http://www.prisonersofthecensus.org/data/2010blocks/261390249002039/
2.61E+14,58,0,5,0,3,2,35,103,221,324,31.79012346,68.20987654,tract_part,http://www.prisonersofthecensus.org/data/2010blocks/261390220011001/
2.61E+14,0,1,0,0,1,1,3,6,23,29,20.68965517,79.31034483,tract_part,http://www.prisonersofthecensus.org/data/2010blocks/261419502002005/
2.61E+14,0,0,0,0,0,3,0,3,57,60,5,95,tract_part,http://www.prisonersofthecensus.org/data/2010blocks/261439703002045/
2.61E+14,10,1,0,0,2,1,2,16,4,20,80,20,tract,http://www.prisonersofthecensus.org/data/2010blocks/261450002001020/
2.61E+14,313,1,0,0,1,7,34,356,144,500,71.2,28.8,tract,http://www.prisonersofthecensus.org/data/2010blocks/261450017002009/
2.61E+14,839,13,5,0,0,0,15,872,598,1470,59.31972789,40.68027211,tract_part,http://www.prisonersofthecensus.org/data/2010blocks/261450101004017/
2.61E+14,120,0,1,0,0,1,24,146,273,419,34.84486874,65.15513126,tract_part,http://www.prisonersofthecensus.org/data/2010blocks/261476360003024/
2.61E+14,18,0,0,0,1,5,4,28,111,139,20.14388489,79.85611511,tract_part,http://www.prisonersofthecensus.org/data/2010blocks/261490413002079/
2.61E+14,3,0,0,0,1,1,1,6,46,52,11.53846154,88.46153846,tract_part,http://www.prisonersofthecensus.org/data/2010blocks/261490402001005/
2.62E+14,29,0,0,0,12,0,12,53,53,106,50,50,tract_part,http://www.prisonersofthecensus.org/data/2010blocks/261519709002028/
2.62E+14,0,1,0,0,0,0,0,1,23,24,4.166666667,95.83333333,tract_part,http://www.prisonersofthecensus.org/data/2010blocks/261530003002068/
2.62E+14,15,1,0,0,0,0,1,17,114,131,12.97709924,87.02290076,tract_part,http://www.prisonersofthecensus.org/data/2010blocks/261550316001010/
2.62E+14,0,0,0,0,0,0,0,0,7,7,0,100,tract_part,http://www.prisonersofthecensus.org/data/2010blocks/261550317002012/
2.62E+14,3,0,0,0,0,2,1,6,68,74,8.108108108,91.89189189,tract_part,http://www.prisonersofthecensus.org/data/2010blocks/261570006002035/
2.62E+14,71,2,1,0,1,1,0,76,77,153,49.67320261,50.32679739,tract_part,http://www.prisonersofthecensus.org/data/2010blocks/261570007003088/
2.62E+14,0,0,0,0,0,0,10,10,0,10,100,0,tract_part,http://www.prisonersofthecensus.org/data/2010blocks/261590115005016/
2.62E+14,30,0,1,0,1,1,15,48,92,140,34.28571429,65.71428571,tract_part,http://www.prisonersofthecensus.org/data/2010blocks/261590118007027/
2.62E+14,69,2,0,0,0,0,0,71,131,202,35.14851485,64.85148515,tract_part,http://www.prisonersofthecensus.org/data/2010blocks/261614450002025/
2.62E+14,208,0,1,0,0,2,2,213,133,346,61.56069364,38.43930636,tract,http://www.prisonersofthecensus.org/data/2010blocks/261614140001000/
2.62E+14,611,28,21,3,61,66,196,986,426,1412,69.83002833,30.16997167,tract_part,http://www.prisonersofthecensus.org/data/2010blocks/261614219001005/
2.62E+14,4,0,0,0,0,0,0,4,2,6,66.66666667,33.33333333,tract,http://www.prisonersofthecensus.org/data/2010blocks/261635761001028/
2.62E+14,6,0,4,0,2,0,2,14,3,17,82.35294118,17.64705882,tract,http://www.prisonersofthecensus.org/data/2010blocks/261635743001058/
2.62E+14,730,2,6,0,0,7,64,809,231,1040,77.78846154,22.21153846,institutionalized,http://www.prisonersofthecensus.org/data/2010blocks/261635064001017/
2.62E+14,680,5,1,1,0,4,48,739,306,1045,70.71770335,29.28229665,institutionalized,http://www.prisonersofthecensus.org/data/2010blocks/261635064003002/
2.62E+14,22,0,0,0,0,0,0,22,15,37,59.45945946,40.54054054,tract,http://www.prisonersofthecensus.org/data/2010blocks/261635136001014/
2.62E+14,63,0,0,0,0,0,1,64,4,68,94.11764706,5.882352941,tract,http://www.prisonersofthecensus.org/data/2010blocks/261635141003004/
2.62E+14,6,0,0,0,0,0,0,6,3,9,66.66666667,33.33333333,tract,http://www.prisonersofthecensus.org/data/2010blocks/261635159003017/
2.62E+14,14,1,0,0,0,4,0,19,5,24,79.16666667,20.83333333,tract,http://www.prisonersofthecensus.org/data/2010blocks/261635160001012/
2.62E+14,27,0,0,0,0,2,2,31,15,46,67.39130435,32.60869565,tract,http://www.prisonersofthecensus.org/data/2010blocks/261635168001020/
2.62E+14,157,3,0,0,2,10,11,183,47,230,79.56521739,20.43478261,institutionalized,http://www.prisonersofthecensus.org/data/2010blocks/261635172002039/
2.62E+14,208,0,0,0,2,12,16,238,39,277,85.92057762,14.07942238,institutionalized,http://www.prisonersofthecensus.org/data/2010blocks/261635172002046/
2.62E+14,0,0,0,0,4,0,4,8,0,8,100,0,tract,http://www.prisonersofthecensus.org/data/2010blocks/261635250003040/
2.62E+14,3,0,0,0,0,0,0,3,0,3,100,0,tract,http://www.prisonersofthecensus.org/data/2010blocks/261635356001011/
2.62E+14,9,1,0,0,0,1,3,14,1,15,93.33333333,6.666666667,tract,http://www.prisonersofthecensus.org/data/2010blocks/261635363006012/
2.62E+14,6,0,0,0,0,0,1,7,5,12,58.33333333,41.66666667,tract,http://www.prisonersofthecensus.org/data/2010blocks/261635798001008/
2.62E+14,276,3,4,0,8,13,23,327,113,440,74.31818182,25.68181818,tract,http://www.prisonersofthecensus.org/data/2010blocks/261635528001005/
2.62E+14,7,0,0,0,0,0,0,7,5,12,58.33333333,41.66666667,tract,http://www.prisonersofthecensus.org/data/2010blocks/261635774001015/
2.62E+14,0,0,0,0,0,0,0,0,1,1,0,100,tract,http://www.prisonersofthecensus.org/data/2010blocks/261635612001031/
2.62E+14,0,0,0,0,0,0,0,0,1,1,0,100,tract,http://www.prisonersofthecensus.org/data/2010blocks/261635617001008/
2.62E+14,1,0,0,0,0,0,1,2,6,8,25,75,tract,http://www.prisonersofthecensus.org/data/2010blocks/261635842002004/
2.62E+14,1,0,0,0,0,0,2,3,80,83,3.614457831,96.38554217,tract_part,http://www.prisonersofthecensus.org/data/2010blocks/261653806003032/
2.70E+14,10,9,0,0,0,0,1,20,59,79,25.3164557,74.6835443,tract_part,http://www.prisonersofthecensus.org/data/2010blocks/270017703003002/
2.70E+14,54,6,7,0,0,0,42,109,94,203,53.69458128,46.30541872,tract,http://www.prisonersofthecensus.org/data/2010blocks/270030505011023/
2.70E+14,406,85,33,0,0,2,80,606,701,1307,46.36572303,53.63427697,tract,http://www.prisonersofthecensus.org/data/2010blocks/270030502291020/
2.70E+14,0,13,0,0,0,1,3,17,15,32,53.125,46.875,institutionalized,http://www.prisonersofthecensus.org/data/2010blocks/270054505001010/
2.70E+14,0,15,0,0,0,3,1,19,16,35,54.28571429,45.71428571,institutionalized,http://www.prisonersofthecensus.org/data/2010blocks/270054505003080/
2.70E+14,2,43,0,0,0,2,0,47,40,87,54.02298851,45.97701149,tract_part,http://www.prisonersofthecensus.org/data/2010blocks/270074506005019/
2.70E+14,14,1,2,0,0,0,1,18,40,58,31.03448276,68.96551724,tract_part,http://www.prisonersofthecensus.org/data/2010blocks/270090201003013/
2.70E+14,0,0,0,0,0,1,0,1,3,4,25,75,tract_part,http://www.prisonersofthecensus.org/data/2010blocks/270090203001061/
2.70E+14,14,0,1,0,0,0,3,18,54,72,25,75,tract_part,http://www.prisonersofthecensus.org/data/2010blocks/270131705002046/
2.70E+14,2,0,0,0,0,0,2,4,13,17,23.52941176,76.47058824,tract,http://www.prisonersofthecensus.org/data/2010blocks/270159602004011/
2.70E+14,4,12,1,0,0,0,3,20,28,48,41.66666667,58.33333333,tract_part,http://www.prisonersofthecensus.org/data/2010blocks/270170704002010/
2.70E+14,353,59,22,0,2,8,75,519,617,1136,45.68661972,54.31338028,tract_part,http://www.prisonersofthecensus.org/data/2010blocks/270170705005021/
2.70E+14,10,3,0,1,1,4,29,48,43,91,52.74725275,47.25274725,tract_part,http://www.prisonersofthecensus.org/data/2010blocks/270190910002050/
2.70E+14,0,11,0,0,0,0,0,11,4,15,73.33333333,26.66666667,tract_part,http://www.prisonersofthecensus.org/data/2010blocks/270219400014073/
2.70E+14,1,0,0,0,1,0,2,4,9,13,30.76923077,69.23076923,tract_part,http://www.prisonersofthecensus.org/data/2010blocks/270239506004008/
2.70E+14,2,3,0,0,0,0,2,7,33,40,17.5,82.5,tract_part,http://www.prisonersofthecensus.org/data/2010blocks/270251105012151/
2.70E+14,389,110,23,0,0,0,50,572,409,981,58.30784913,41.69215087,tract_part,http://www.prisonersofthecensus.org/data/2010blocks/270251102001049/
2.70E+14,7,9,0,0,9,1,13,39,25,64,60.9375,39.0625,tract,http://www.prisonersofthecensus.org/data/2010blocks/270270202021023/
2.70E+14,0,8,0,0,0,0,1,9,10,19,47.36842105,52.63157895,tract_part,http://www.prisonersofthecensus.org/data/2010blocks/270290001001137/
2.70E+14,0,0,0,0,0,0,0,0,3,3,0,100,tract_part,http://www.prisonersofthecensus.org/data/2010blocks/270314801003484/
2.70E+14,0,0,1,0,0,0,2,3,10,13,23.07692308,76.92307692,tract_part,http://www.prisonersofthecensus.org/data/2010blocks/270332703004012/
2.70E+14,11,34,0,0,1,2,1,49,76,125,39.2,60.8,tract_part,http://www.prisonersofthecensus.org/data/2010blocks/270359511004012/
2.70E+14,0,0,1,0,0,0,0,1,3,4,25,75,tract,http://www.prisonersofthecensus.org/data/2010blocks/270370607132023/
2.70E+14,78,9,2,1,5,10,26,131,137,268,48.88059701,51.11940299,tract_part,http://www.prisonersofthecensus.org/data/2010blocks/270370611022017/
2.70E+14,3,0,1,0,0,1,0,5,29,34,14.70588235,85.29411765,tract_part,http://www.prisonersofthecensus.org/data/2010blocks/270370611082035/
2.70E+14,3,1,0,0,0,0,0,4,31,35,11.42857143,88.57142857,institutionalized,http://www.prisonersofthecensus.org/data/2010blocks/270414507013018/
2.70E+14,4,2,0,0,0,0,0,6,18,24,25,75,institutionalized,http://www.prisonersofthecensus.org/data/2010blocks/270414507013019/
2.70E+14,0,0,0,0,0,0,3,3,24,27,11.11111111,88.88888889,tract_part,http://www.prisonersofthecensus.org/data/2010blocks/270434604003007/
2.70E+14,3,0,0,0,0,0,0,3,14,17,17.64705882,82.35294118,tract_part,http://www.prisonersofthecensus.org/data/2010blocks/270459604003070/
2.70E+14,13,5,3,0,8,5,43,77,37,114,67.54385965,32.45614035,tract_part,http://www.prisonersofthecensus.org/data/2010blocks/270471808002049/
2.70E+14,5,1,0,0,0,0,3,9,46,55,16.36363636,83.63636364,tract,http://www.prisonersofthecensus.org/data/2010blocks/270490801011010/
2.71E+14,6,0,0,0,0,2,0,8,8,16,50,50,tract_part,http://www.prisonersofthecensus.org/data/2010blocks/270530216021014/
2.71E+14,18,1,3,0,0,0,1,23,3,26,88.46153846,11.53846154,tract,http://www.prisonersofthecensus.org/data/2010blocks/270530038002011/
2.71E+14,23,3,1,0,0,3,0,30,14,44,68.18181818,31.81818182,tract,http://www.prisonersofthecensus.org/data/2010blocks/270530082002001/
2.71E+14,13,1,0,0,1,2,2,19,7,26,73.07692308,26.92307692,tract,http://www.prisonersofthecensus.org/data/2010blocks/270530084001000/
2.71E+14,0,0,0,0,0,0,0,0,2,2,0,100,tract,http://www.prisonersofthecensus.org/data/2010blocks/270530110004019/
2.71E+14,1,1,0,0,0,0,0,2,5,7,28.57142857,71.42857143,tract,http://www.prisonersofthecensus.org/data/2010blocks/270531039001004/
2.71E+14,13,0,2,0,1,2,1,19,3,22,86.36363636,13.63636364,tract,http://www.prisonersofthecensus.org/data/2010blocks/270531056003000/
2.71E+14,3,1,1,0,0,1,1,7,19,26,26.92307692,73.07692308,tract,http://www.prisonersofthecensus.org/data/2010blocks/270531067004006/
2.71E+14,25,2,5,0,0,3,2,37,23,60,61.66666667,38.33333333,tract,http://www.prisonersofthecensus.org/data/2010blocks/270531088004002/
2.71E+14,226,11,2,0,1,1,20,261,30,291,89.69072165,10.30927835,institutionalized,http://www.prisonersofthecensus.org/data/2010blocks/270531261003037/
2.71E+14,183,23,14,0,0,2,28,250,113,363,68.87052342,31.12947658,institutionalized,http://www.prisonersofthecensus.org/data/2010blocks/270531261003038/
2.71E+14,229,33,6,1,16,21,40,346,144,490,70.6122449,29.3877551,tract,http://www.prisonersofthecensus.org/data/2010blocks/270530266103000/
2.71E+14,1,0,0,0,0,0,0,1,12,13,7.692307692,92.30769231,tract_part,http://www.prisonersofthecensus.org/data/2010blocks/270550205002049/
2.71E+14,0,0,0,0,0,0,0,0,6,6,0,100,tract_part,http://www.prisonersofthecensus.org/data/2010blocks/270570701001106/
2.71E+14,0,5,1,0,0,0,0,6,19,25,24,76,tract_part,http://www.prisonersofthecensus.org/data/2010blocks/270570706003053/
2.71E+14,0,0,1,0,1,0,2,4,38,42,9.523809524,90.47619048,tract_part,http://www.prisonersofthecensus.org/data/2010blocks/270591303012107/
2.71E+14,3,14,0,0,0,2,1,20,36,56,35.71428571,64.28571429,tract_part,http://www.prisonersofthecensus.org/data/2010blocks/270614809004046/
2.71E+14,2,1,0,0,0,0,0,3,9,12,25,75,tract_part,http://www.prisonersofthecensus.org/data/2010blocks/270634804004035/
2.71E+14,0,1,0,0,0,3,0,4,25,29,13.79310345,86.20689655,tract_part,http://www.prisonersofthecensus.org/data/2010blocks/270654803002001/
2.71E+14,18,2,3,0,7,4,53,87,71,158,55.06329114,44.93670886,tract_part,http://www.prisonersofthecensus.org/data/2010blocks/270677805001013/
2.71E+14,0,0,0,0,0,0,0,0,1,1,0,100,tract_part,http://www.prisonersofthecensus.org/data/2010blocks/270677810002018/
2.71E+14,0,0,0,0,0,0,0,0,1,1,0,100,tract_part,http://www.prisonersofthecensus.org/data/2010blocks/270690902003093/
2.71E+14,1,1,0,0,0,0,0,2,7,9,22.22222222,77.77777778,tract_part,http://www.prisonersofthecensus.org/data/2010blocks/270717902005003/
2.71E+14,0,0,0,0,0,0,0,0,2,2,0,100,tract_part,http://www.prisonersofthecensus.org/data/2010blocks/270731801002029/
2.71E+14,1,2,1,0,0,0,0,4,15,19,21.05263158,78.94736842,tract_part,http://www.prisonersofthecensus.org/data/2010blocks/270753704002062/
2.71E+14,0,0,0,0,0,0,0,0,2,2,0,100,tract_part,http://www.prisonersofthecensus.org/data/2010blocks/270774603001072/
2.71E+14,0,0,0,0,0,0,0,0,3,3,0,100,tract_part,http://www.prisonersofthecensus.org/data/2010blocks/270812010012148/
2.71E+14,7,0,0,0,2,1,11,21,23,44,47.72727273,52.27272727,tract_part,http://www.prisonersofthecensus.org/data/2010blocks/270833603003019/
2.71E+14,1,2,0,0,2,0,2,7,21,28,25,75,tract_part,http://www.prisonersofthecensus.org/data/2010blocks/270859507004032/
2.71E+14,0,0,0,0,0,0,0,0,6,6,0,100,tract_part,http://www.prisonersofthecensus.org/data/2010blocks/270890804001146/
2.71E+14,2,7,2,1,0,0,3,15,6,21,71.42857143,28.57142857,tract_part,http://www.prisonersofthecensus.org/data/2010blocks/270917905001025/
2.71E+14,4,1,0,0,1,1,1,8,30,38,21.05263158,78.94736842,tract_part,http://www.prisonersofthecensus.org/data/2010blocks/270935604003029/
2.71E+14,7,21,0,0,1,1,1,31,44,75,41.33333333,58.66666667,tract_part,http://www.prisonersofthecensus.org/data/2010blocks/270951705002043/
2.71E+14,10,2,0,0,0,0,2,14,44,58,24.13793103,75.86206897,tract_part,http://www.prisonersofthecensus.org/data/2010blocks/270977806004049/
2.71E+14,3,0,0,0,0,0,16,19,13,32,59.375,40.625,tract_part,http://www.prisonersofthecensus.org/data/2010blocks/270990004101018/
2.71E+14,6,2,0,0,0,0,2,10,9,19,52.63157895,47.36842105,tract_part,http://www.prisonersofthecensus.org/data/2010blocks/271034804003055/
2.71E+14,17,1,4,0,1,0,15,38,32,70,54.28571429,45.71428571,tract_part,http://www.prisonersofthecensus.org/data/2010blocks/271051054001006/
2.71E+14,30,5,2,0,1,5,16,59,58,117,50.42735043,49.57264957,institutionalized,http://www.prisonersofthecensus.org/data/2010blocks/271090003001003/
2.71E+14,1,1,0,0,0,0,0,2,4,6,33.33333333,66.66666667,institutionalized,http://www.prisonersofthecensus.org/data/2010blocks/271090003001006/
2.71E+14,4,0,0,0,0,0,1,5,9,14,35.71428571,64.28571429,tract_part,http://www.prisonersofthecensus.org/data/2010blocks/271090010001014/
2.71E+14,346,48,9,2,16,38,205,664,333,997,66.5997994,33.4002006,tract_part,http://www.prisonersofthecensus.org/data/2010blocks/271090023005012/
2.71E+14,5,5,0,0,1,3,1,15,39,54,27.77777778,72.22222222,tract_part,http://www.prisonersofthecensus.org/data/2010blocks/271119610002000/
2.71E+14,0,1,0,0,0,0,0,1,6,7,14.28571429,85.71428571,tract_part,http://www.prisonersofthecensus.org/data/2010blocks/271130902003029/
2.71E+14,1,5,0,0,0,0,2,8,21,29,27.5862069,72.4137931,tract_part,http://www.prisonersofthecensus.org/data/2010blocks/271130904002000/
2.71E+14,2,11,0,0,0,2,2,17,25,42,40.47619048,59.52380952,tract_part,http://www.prisonersofthecensus.org/data/2010blocks/271130901001171/
2.71E+14,6,26,2,0,0,0,0,34,70,104,32.69230769,67.30769231,tract_part,http://www.prisonersofthecensus.org/data/2010blocks/271159507001020/
2.71E+14,0,0,0,0,0,0,0,0,3,3,0,100,tract_part,http://www.prisonersofthecensus.org/data/2010blocks/271159508001019/
2.71E+14,437,109,13,3,91,38,278,969,472,1441,67.24496877,32.75503123,tract_part,http://www.prisonersofthecensus.org/data/2010blocks/271159504002132/
2.71E+14,46,7,3,0,0,0,10,66,100,166,39.75903614,60.24096386,tract_part,http://www.prisonersofthecensus.org/data/2010blocks/271159502002091/
2.71E+14,0,0,0,0,0,0,1,1,7,8,12.5,87.5,tract_part,http://www.prisonersofthecensus.org/data/2010blocks/271174603003015/
2.71E+14,0,1,0,0,0,0,1,2,6,8,25,75,tract_part,http://www.prisonersofthecensus.org/data/2010blocks/271190207001013/
2.71E+14,10,12,0,0,11,5,24,62,88,150,41.33333333,58.66666667,tract_part,http://www.prisonersofthecensus.org/data/2010blocks/271190207001031/
2.71E+14,203,20,16,0,4,3,28,274,163,437,62.70022883,37.29977117,tract,http://www.prisonersofthecensus.org/data/2010blocks/271230425041025/
2.71E+14,14,3,2,0,4,1,7,31,20,51,60.78431373,39.21568627,tract,http://www.prisonersofthecensus.org/data/2010blocks/271230416022008/
2.71E+14,209,13,36,3,10,2,63,336,137,473,71.0359408,28.9640592,tract,http://www.prisonersofthecensus.org/data/2010blocks/271230330002035/
2.71E+14,1,0,1,0,0,1,0,3,9,12,25,75,tract,http://www.prisonersofthecensus.org/data/2010blocks/271230332001015/
2.71E+14,3,0,0,0,0,0,0,3,1,4,75,25,tract,http://www.prisonersofthecensus.org/data/2010blocks/271230345003006/
2.71E+14,8,0,0,0,0,2,0,10,5,15,66.66666667,33.33333333,tract,http://www.prisonersofthecensus.org/data/2010blocks/271230349003001/
2.71E+14,21,1,1,0,0,0,2,25,9,34,73.52941176,26.47058824,tract,http://www.prisonersofthecensus.org/data/2010blocks/271230355002007/
2.71E+14,13,1,2,0,0,1,5,22,12,34,64.70588235,35.29411765,tract,http://www.prisonersofthecensus.org/data/2010blocks/271230369002033/
2.71E+14,0,0,9,0,0,0,0,9,0,9,100,0,tract_part,http://www.prisonersofthecensus.org/data/2010blocks/271230401005000/
2.71E+14,0,0,0,0,0,0,0,0,4,4,0,100,tract_part,http://www.prisonersofthecensus.org/data/2010blocks/271230404022006/
2.71E+14,1,2,0,0,0,0,1,4,12,16,25,75,tract_part,http://www.prisonersofthecensus.org/data/2010blocks/271277503002009/
2.71E+14,2,3,0,0,8,0,7,20,20,40,50,50,tract_part,http://www.prisonersofthecensus.org/data/2010blocks/271297905002006/
2.71E+14,750,120,60,0,1,7,218,1156,911,2067,55.92646347,44.07353653,remaining,http://www.prisonersofthecensus.org/data/2010blocks/271310707003013/
2.71E+14,7,0,0,0,0,1,12,20,6,26,76.92307692,23.07692308,institutionalized,http://www.prisonersofthecensus.org/data/2010blocks/271310707004014/
2.71E+14,0,2,0,0,0,1,2,5,9,14,35.71428571,64.28571429,tract_part,http://www.prisonersofthecensus.org/data/2010blocks/271359703001111/
2.71E+14,28,30,0,0,0,0,1,59,105,164,35.97560976,64.02439024,tract_part,http://www.prisonersofthecensus.org/data/2010blocks/271370003001063/
2.71E+14,7,6,1,0,0,0,0,14,31,45,31.11111111,68.88888889,tract,http://www.prisonersofthecensus.org/data/2010blocks/271370020002004/
2.71E+14,14,24,0,1,0,0,0,39,111,150,26,74,institutionalized,http://www.prisonersofthecensus.org/data/2010blocks/271370111002003/
2.71E+14,0,0,0,0,0,0,0,0,2,2,0,100,institutionalized,http://www.prisonersofthecensus.org/data/2010blocks/271370111002011/
2.71E+14,178,36,21,1,24,27,112,399,418,817,48.8372093,51.1627907,tract_part,http://www.prisonersofthecensus.org/data/2010blocks/271370003001043/
2.71E+14,0,3,0,0,0,0,0,3,4,7,42.85714286,57.14285714,tract,http://www.prisonersofthecensus.org/data/2010blocks/271370123001013/
2.71E+14,14,3,4,0,6,2,11,40,58,98,40.81632653,59.18367347,institutionalized,http://www.prisonersofthecensus.org/data/2010blocks/271390805001030/
2.71E+14,117,86,9,1,1,0,34,248,350,598,41.47157191,58.52842809,institutionalized,http://www.prisonersofthecensus.org/data/2010blocks/271390805002009/
2.71E+14,118,22,24,2,0,2,189,357,145,502,71.11553785,28.88446215,tract,http://www.prisonersofthecensus.org/data/2010blocks/271410305031031/
2.71E+14,371,85,19,0,0,0,73,548,453,1001,54.74525475,45.25474525,tract_part,http://www.prisonersofthecensus.org/data/2010blocks/271410315004008/
2.71E+14,0,0,0,0,0,0,2,2,7,9,22.22222222,77.77777778,tract_part,http://www.prisonersofthecensus.org/data/2010blocks/271431703003027/
2.71E+14,33,1,1,0,0,0,18,53,97,150,35.33333333,64.66666667,tract,http://www.prisonersofthecensus.org/data/2010blocks/271450116002015/
2.71E+14,16,3,2,1,11,3,23,59,55,114,51.75438596,48.24561404,tract_part,http://www.prisonersofthecensus.org/data/2010blocks/271479604003050/
2.72E+14,0,1,0,0,0,0,0,1,7,8,12.5,87.5,tract_part,http://www.prisonersofthecensus.org/data/2010blocks/271519602002032/
2.72E+14,5,3,0,0,0,0,4,12,37,49,24.48979592,75.51020408,tract_part,http://www.prisonersofthecensus.org/data/2010blocks/271537906003011/
2.72E+14,2,0,0,0,0,0,0,2,3,5,40,60,tract_part,http://www.prisonersofthecensus.org/data/2010blocks/271554601002030/
2.72E+14,0,0,0,0,0,0,4,4,11,15,26.66666667,73.33333333,tract_part,http://www.prisonersofthecensus.org/data/2010blocks/271574901001046/
2.72E+14,5,1,0,0,0,0,0,6,20,26,23.07692308,76.92307692,tract_part,http://www.prisonersofthecensus.org/data/2010blocks/271594803002060/
2.72E+14,0,1,0,0,0,0,2,3,16,19,15.78947368,84.21052632,institutionalized,http://www.prisonersofthecensus.org/data/2010blocks/271617905002087/
2.72E+14,236,102,15,1,51,80,275,760,417,1177,64.57094308,35.42905692,institutionalized,http://www.prisonersofthecensus.org/data/2010blocks/271617905002104/
2.72E+14,646,161,44,0,1,0,120,972,620,1592,61.05527638,38.94472362,tract,http://www.prisonersofthecensus.org/data/2010blocks/271630708011001/
2.72E+14,181,55,5,0,0,1,39,281,168,449,62.58351893,37.41648107,tract,http://www.prisonersofthecensus.org/data/2010blocks/271630708021001/
2.72E+14,42,6,2,0,0,0,8,58,148,206,28.15533981,71.84466019,tract_part,http://www.prisonersofthecensus.org/data/2010blocks/271630707032035/
2.72E+14,2,1,0,0,0,0,3,6,10,16,37.5,62.5,tract_part,http://www.prisonersofthecensus.org/data/2010blocks/271659502003017/
2.72E+14,3,1,0,0,0,0,1,5,7,12,41.66666667,58.33333333,tract_part,http://www.prisonersofthecensus.org/data/2010blocks/271679502004049/
2.72E+14,7,0,0,0,0,1,1,9,38,47,19.14893617,80.85106383,tract,http://www.prisonersofthecensus.org/data/2010blocks/271696705001034/
2.72E+14,11,3,0,0,0,0,5,19,108,127,14.96062992,85.03937008,tract_part,http://www.prisonersofthecensus.org/data/2010blocks/271711007031015/
2.72E+14,1,5,0,0,0,0,0,6,13,19,31.57894737,68.42105263,tract_part,http://www.prisonersofthecensus.org/data/2010blocks/271739701002021/
2.80E+14,48,0,0,0,0,1,0,49,13,62,79.03225806,20.96774194,tract_part,http://www.prisonersofthecensus.org/data/2010blocks/280010007002032/
2.80E+14,15,0,0,0,0,0,0,15,1,16,93.75,6.25,tract_part,http://www.prisonersofthecensus.org/data/2010blocks/280010004002031/
2.80E+14,155,20,25,2,393,148,1818,2561,45,2606,98.27321566,1.726784344,tract_part,http://www.prisonersofthecensus.org/data/2010blocks/280010001001036/
2.80E+14,6,0,0,0,0,0,0,6,13,19,31.57894737,68.42105263,tract_part,http://www.prisonersofthecensus.org/data/2010blocks/280039503003080/
2.80E+14,18,0,0,0,0,0,2,20,40,60,33.33333333,66.66666667,institutionalized,http://www.prisonersofthecensus.org/data/2010blocks/280039505001075/
2.80E+14,45,0,0,0,0,0,1,46,30,76,60.52631579,39.47368421,remaining,http://www.prisonersofthecensus.org/data/2010blocks/280039505004060/
2.80E+14,34,0,0,0,0,0,0,34,5,39,87.17948718,12.82051282,tract_part,http://www.prisonersofthecensus.org/data/2010blocks/280059501004064/
2.80E+14,17,0,0,0,0,0,0,17,8,25,68,32,tract_part,http://www.prisonersofthecensus.org/data/2010blocks/280070606003056/
2.80E+14,3,0,0,0,0,0,1,4,5,9,44.44444444,55.55555556,tract_part,http://www.prisonersofthecensus.org/data/2010blocks/280099501004032/
2.80E+14,68,0,0,0,0,0,0,68,24,92,73.91304348,26.08695652,tract_part,http://www.prisonersofthecensus.org/data/2010blocks/280119502003083/
2.80E+14,260,0,0,0,1,0,0,261,142,403,64.76426799,35.23573201,tract_part,http://www.prisonersofthecensus.org/data/2010blocks/280119504001040/
2.80E+14,16,0,0,0,0,0,0,16,9,25,64,36,tract_part,http://www.prisonersofthecensus.org/data/2010blocks/280139503001062/
2.80E+14,199,0,0,0,0,0,0,199,80,279,71.32616487,28.67383513,tract_part,http://www.prisonersofthecensus.org/data/2010blocks/280159502005026/
2.80E+14,30,1,0,0,0,1,1,33,37,70,47.14285714,52.85714286,tract_part,http://www.prisonersofthecensus.org/data/2010blocks/280179503002011/
2.80E+14,15,0,0,1,0,0,0,16,10,26,61.53846154,38.46153846,tract_part,http://www.prisonersofthecensus.org/data/2010blocks/280199503001026/
2.80E+14,33,0,0,0,1,1,1,36,13,49,73.46938776,26.53061224,tract_part,http://www.prisonersofthecensus.org/data/2010blocks/280239504001019/
2.80E+14,95,0,2,0,1,1,5,104,41,145,71.72413793,28.27586207,tract_part,http://www.prisonersofthecensus.org/data/2010blocks/280259503001018/
2.80E+14,71,0,0,0,0,2,0,73,9,82,89.02439024,10.97560976,tract_part,http://www.prisonersofthecensus.org/data/2010blocks/280279504003008/
2.80E+14,2,0,0,0,0,0,0,2,1,3,66.66666667,33.33333333,tract_part,http://www.prisonersofthecensus.org/data/2010blocks/280319502001085/
2.80E+14,103,0,0,0,2,4,7,116,116,232,50,50,tract_part,http://www.prisonersofthecensus.org/data/2010blocks/280330711201037/
2.80E+14,67,0,0,0,0,0,0,67,19,86,77.90697674,22.09302326,tract_part,http://www.prisonersofthecensus.org/data/2010blocks/280350005001059/
2.80E+14,137,0,0,0,2,0,2,141,75,216,65.27777778,34.72222222,tract_part,http://www.prisonersofthecensus.org/data/2010blocks/280350107001054/
2.80E+14,21,0,0,0,0,0,0,21,17,38,55.26315789,44.73684211,tract_part,http://www.prisonersofthecensus.org/data/2010blocks/280350105003043/
2.80E+14,6,0,0,0,0,0,0,6,4,10,60,40,tract_part,http://www.prisonersofthecensus.org/data/2010blocks/280379501004069/
2.80E+14,233,0,0,0,0,2,3,238,236,474,50.21097046,49.78902954,tract_part,http://www.prisonersofthecensus.org/data/2010blocks/280399502002000/
2.80E+14,1882,3,3,0,10,12,44,1954,1010,2964,65.92442645,34.07557355,tract_part,http://www.prisonersofthecensus.org/data/2010blocks/280419501004191/
2.80E+14,77,0,0,0,0,2,6,85,54,139,61.15107914,38.84892086,tract_part,http://www.prisonersofthecensus.org/data/2010blocks/280439504002010/
2.80E+14,55,0,1,0,0,0,2,58,101,159,36.47798742,63.52201258,tract_part,http://www.prisonersofthecensus.org/data/2010blocks/280470027002018/
2.80E+14,327,0,11,0,4,12,35,389,435,824,47.20873786,52.79126214,tract_part,http://www.prisonersofthecensus.org/data/2010blocks/280470032081041/
2.80E+14,53,0,0,0,0,0,1,54,31,85,63.52941176,36.47058824,tract_part,http://www.prisonersofthecensus.org/data/2010blocks/280479800001025/
2.80E+14,788,1,1,0,1,1,5,797,121,918,86.81917211,13.18082789,tract_part,http://www.prisonersofthecensus.org/data/2010blocks/280490107001045/
2.80E+14,84,0,0,0,0,1,2,87,26,113,76.99115044,23.00884956,tract_part,http://www.prisonersofthecensus.org/data/2010blocks/280490027002126/
2.80E+14,47,0,0,0,0,1,0,48,18,66,72.72727273,27.27272727,tract,http://www.prisonersofthecensus.org/data/2010blocks/280490030001003/
2.81E+14,24,0,0,0,2,0,5,31,0,31,100,0,tract_part,http://www.prisonersofthecensus.org/data/2010blocks/280539503003044/
2.81E+14,211,0,0,0,0,1,4,216,36,252,85.71428571,14.28571429,tract_part,http://www.prisonersofthecensus.org/data/2010blocks/280559501002033/
2.81E+14,2,0,0,0,0,0,0,2,14,16,12.5,87.5,tract_part,http://www.prisonersofthecensus.org/data/2010blocks/280579503002068/
2.81E+14,225,0,1,0,0,0,1,227,286,513,44.24951267,55.75048733,tract_part,http://www.prisonersofthecensus.org/data/2010blocks/280590422001005/
2.81E+14,1,0,0,0,0,0,0,1,4,5,20,80,tract_part,http://www.prisonersofthecensus.org/data/2010blocks/280590405003029/
2.81E+14,49,0,0,0,0,0,0,49,17,66,74.24242424,25.75757576,tract_part,http://www.prisonersofthecensus.org/data/2010blocks/280619502001056/
2.81E+14,70,0,0,0,0,0,1,71,25,96,73.95833333,26.04166667,remaining,http://www.prisonersofthecensus.org/data/2010blocks/280639502001063/
2.81E+14,205,0,0,0,1,0,1,207,34,241,85.89211618,14.10788382,institutionalized,http://www.prisonersofthecensus.org/data/2010blocks/280639502001072/
2.81E+14,18,0,0,0,0,1,0,19,5,24,79.16666667,20.83333333,tract_part,http://www.prisonersofthecensus.org/data/2010blocks/280659501005030/
2.81E+14,81,0,0,0,7,0,10,98,95,193,50.77720207,49.22279793,tract_part,http://www.prisonersofthecensus.org/data/2010blocks/280679506005076/
2.81E+14,240,2,0,0,0,0,0,242,91,333,72.67267267,27.32732733,tract_part,http://www.prisonersofthecensus.org/data/2010blocks/280690301002020/
2.81E+14,116,1,0,0,1,0,14,132,38,170,77.64705882,22.35294118,tract_part,http://www.prisonersofthecensus.org/data/2010blocks/280719502011021/
2.81E+14,34,0,0,0,0,1,0,35,95,130,26.92307692,73.07692308,tract_part,http://www.prisonersofthecensus.org/data/2010blocks/280730204003042/
2.81E+14,13,0,0,0,0,0,0,13,6,19,68.42105263,31.57894737,tract_part,http://www.prisonersofthecensus.org/data/2010blocks/280750011022006/
2.81E+14,128,3,1,0,1,0,2,135,71,206,65.53398058,34.46601942,tract_part,http://www.prisonersofthecensus.org/data/2010blocks/280750107002060/
2.81E+14,12,0,0,0,0,0,0,12,3,15,80,20,tract_part,http://www.prisonersofthecensus.org/data/2010blocks/280750009005001/
2.81E+14,835,0,0,0,0,7,0,842,415,1257,66.98488465,33.01511535,tract_part,http://www.prisonersofthecensus.org/data/2010blocks/280750104002085/
2.81E+14,210,2,0,0,1,0,1,214,118,332,64.45783133,35.54216867,tract_part,http://www.prisonersofthecensus.org/data/2010blocks/280790406002046/
2.81E+14,122,0,0,0,0,0,0,122,55,177,68.92655367,31.07344633,tract_part,http://www.prisonersofthecensus.org/data/2010blocks/280790404003101/
2.81E+14,115,0,0,0,0,1,0,116,114,230,50.43478261,49.56521739,tract_part,http://www.prisonersofthecensus.org/data/2010blocks/280819505001041/
2.81E+14,5,0,0,0,0,0,0,5,5,10,50,50,tract_part,http://www.prisonersofthecensus.org/data/2010blocks/280819507001014/
2.81E+14,722,1,0,0,0,5,8,736,223,959,76.74661105,23.25338895,tract_part,http://www.prisonersofthecensus.org/data/2010blocks/280839504002000/
2.81E+14,46,0,0,0,0,1,0,47,26,73,64.38356164,35.61643836,tract_part,http://www.prisonersofthecensus.org/data/2010blocks/280859506002018/
2.81E+14,140,0,0,0,0,0,0,140,85,225,62.22222222,37.77777778,tract_part,http://www.prisonersofthecensus.org/data/2010blocks/280870007004001/
2.81E+14,307,5,3,0,1,1,14,331,100,431,76.79814385,23.20185615,tract_part,http://www.prisonersofthecensus.org/data/2010blocks/280890304003017/
2.81E+14,0,0,0,0,0,0,0,0,1,1,0,100,tract_part,http://www.prisonersofthecensus.org/data/2010blocks/280919504001027/
2.81E+14,222,1,0,0,4,2,4,233,168,401,58.10473815,41.89526185,tract_part,http://www.prisonersofthecensus.org/data/2010blocks/280919504004017/
2.81E+14,626,1,0,0,3,2,6,638,269,907,70.34178611,29.65821389,institutionalized,http://www.prisonersofthecensus.org/data/2010blocks/280939504023013/
2.81E+14,47,0,0,0,0,1,0,48,13,61,78.68852459,21.31147541,institutionalized,http://www.prisonersofthecensus.org/data/2010blocks/280939504023033/
2.81E+14,4,0,0,0,0,0,0,4,2,6,66.66666667,33.33333333,tract_part,http://www.prisonersofthecensus.org/data/2010blocks/280959503002077/
2.81E+14,40,0,0,0,1,0,0,41,36,77,53.24675325,46.75324675,tract_part,http://www.prisonersofthecensus.org/data/2010blocks/280959507001037/
2.81E+14,33,8,0,0,0,0,0,41,25,66,62.12121212,37.87878788,tract_part,http://www.prisonersofthecensus.org/data/2010blocks/280990104004012/
2.81E+14,25,2,0,0,0,0,0,27,19,46,58.69565217,41.30434783,tract_part,http://www.prisonersofthecensus.org/data/2010blocks/281010503005008/
2.81E+14,20,0,0,0,0,1,1,22,2,24,91.66666667,8.333333333,tract_part,http://www.prisonersofthecensus.org/data/2010blocks/281039503001045/
2.81E+14,66,0,0,0,0,0,0,66,20,86,76.74418605,23.25581395,tract_part,http://www.prisonersofthecensus.org/data/2010blocks/281039503001003/
2.81E+14,3,0,0,0,0,0,0,3,6,9,33.33333333,66.66666667,institutionalized,http://www.prisonersofthecensus.org/data/2010blocks/281059505001004/
2.81E+14,24,0,0,0,0,0,0,24,11,35,68.57142857,31.42857143,institutionalized,http://www.prisonersofthecensus.org/data/2010blocks/281059505001010/
2.81E+14,55,2,0,0,1,0,3,61,27,88,69.31818182,30.68181818,tract_part,http://www.prisonersofthecensus.org/data/2010blocks/281079503001077/
2.81E+14,78,0,0,1,13,2,16,110,217,327,33.63914373,66.36085627,tract_part,http://www.prisonersofthecensus.org/data/2010blocks/281099502001060/
2.81E+14,153,0,0,0,0,1,0,154,68,222,69.36936937,30.63063063,tract_part,http://www.prisonersofthecensus.org/data/2010blocks/281139506002016/
2.81E+14,26,0,0,0,0,0,0,26,42,68,38.23529412,61.76470588,tract_part,http://www.prisonersofthecensus.org/data/2010blocks/281179501004044/
2.81E+14,11,0,0,0,0,0,0,11,1,12,91.66666667,8.333333333,tract_part,http://www.prisonersofthecensus.org/data/2010blocks/281199502001020/
2.81E+14,64,0,0,0,0,0,0,64,28,92,69.56521739,30.43478261,tract_part,http://www.prisonersofthecensus.org/data/2010blocks/281199503004182/
2.81E+14,78,8,1,0,1,0,3,91,169,260,35,65,tract_part,http://www.prisonersofthecensus.org/data/2010blocks/281210203022110/
2.81E+14,1923,5,2,0,4,4,27,1965,1301,3266,60.16533987,39.83466013,tract_part,http://www.prisonersofthecensus.org/data/2010blocks/281210205001024/
2.81E+14,43,1,0,0,0,0,1,45,17,62,72.58064516,27.41935484,tract_part,http://www.prisonersofthecensus.org/data/2010blocks/281230205004085/
2.81E+14,64,1,0,0,1,0,1,67,33,100,67,33,tract_part,http://www.prisonersofthecensus.org/data/2010blocks/281279505001074/
2.81E+14,1,0,0,0,0,0,0,1,0,1,100,0,tract_part,http://www.prisonersofthecensus.org/data/2010blocks/281279505003066/
2.81E+14,205,0,0,0,0,0,0,205,201,406,50.49261084,49.50738916,tract_part,http://www.prisonersofthecensus.org/data/2010blocks/281310201003041/
2.81E+14,50,0,0,0,0,0,0,50,18,68,73.52941176,26.47058824,institutionalized,http://www.prisonersofthecensus.org/data/2010blocks/281339504021019/
2.81E+14,46,0,0,0,1,0,1,48,18,66,72.72727273,27.27272727,institutionalized,http://www.prisonersofthecensus.org/data/2010blocks/281339504021020/
2.81E+14,30,0,0,0,0,0,3,33,4,37,89.18918919,10.81081081,tract_part,http://www.prisonersofthecensus.org/data/2010blocks/281339504014036/
2.81E+14,2658,2,3,0,14,35,24,2736,1039,3775,72.47682119,27.52317881,tract_part,http://www.prisonersofthecensus.org/data/2010blocks/281339501001062/
2.81E+14,812,26,94,12,350,94,793,2181,591,2772,78.67965368,21.32034632,tract_part,http://www.prisonersofthecensus.org/data/2010blocks/281359503002019/
2.81E+14,47,1,0,0,0,0,2,50,35,85,58.82352941,41.17647059,tract_part,http://www.prisonersofthecensus.org/data/2010blocks/281379503022074/
2.81E+14,5,0,0,0,0,0,2,7,55,62,11.29032258,88.70967742,tract_part,http://www.prisonersofthecensus.org/data/2010blocks/281419503002137/
2.81E+14,37,0,0,0,0,0,0,37,10,47,78.72340426,21.27659574,tract_part,http://www.prisonersofthecensus.org/data/2010blocks/281439502003004/
2.81E+14,39,0,0,0,2,0,4,45,55,100,45,55,tract_part,http://www.prisonersofthecensus.org/data/2010blocks/281459503003050/
2.81E+14,0,0,0,0,0,0,0,0,2,2,0,100,tract_part,http://www.prisonersofthecensus.org/data/2010blocks/281479502001037/
2.82E+14,81,0,0,0,0,1,1,83,23,106,78.30188679,21.69811321,tract_part,http://www.prisonersofthecensus.org/data/2010blocks/281499503002020/
2.82E+14,58,0,0,0,0,0,2,60,13,73,82.19178082,17.80821918,tract_part,http://www.prisonersofthecensus.org/data/2010blocks/281510006002057/
2.82E+14,16,0,0,0,0,0,0,16,2,18,88.88888889,11.11111111,tract_part,http://www.prisonersofthecensus.org/data/2010blocks/281510006002010/
2.82E+14,65,0,0,0,0,0,0,65,21,86,75.58139535,24.41860465,tract_part,http://www.prisonersofthecensus.org/data/2010blocks/281510003001008/
2.82E+14,2,0,0,0,0,0,0,2,0,2,100,0,tract_part,http://www.prisonersofthecensus.org/data/2010blocks/281510020001043/
2.82E+14,9,0,0,0,0,0,0,9,4,13,69.23076923,30.76923077,tract_part,http://www.prisonersofthecensus.org/data/2010blocks/281539502002041/
2.82E+14,4,0,0,0,0,0,0,4,10,14,28.57142857,71.42857143,tract_part,http://www.prisonersofthecensus.org/data/2010blocks/281559503002034/
2.82E+14,65,0,0,0,1,1,2,69,29,98,70.40816327,29.59183673,tract_part,http://www.prisonersofthecensus.org/data/2010blocks/281579502005034/
2.82E+14,13,0,0,0,0,1,0,14,1,15,93.33333333,6.666666667,tract_part,http://www.prisonersofthecensus.org/data/2010blocks/281579502004004/
2.82E+14,751,1,2,0,2,4,3,763,197,960,79.47916667,20.52083333,tract_part,http://www.prisonersofthecensus.org/data/2010blocks/281579502003002/
2.82E+14,181,2,0,0,0,0,1,184,81,265,69.43396226,30.56603774,tract_part,http://www.prisonersofthecensus.org/data/2010blocks/281599501002132/
2.82E+14,14,0,0,0,0,0,0,14,7,21,66.66666667,33.33333333,tract_part,http://www.prisonersofthecensus.org/data/2010blocks/281619502004033/
2.82E+14,66,0,0,0,0,0,3,69,16,85,81.17647059,18.82352941,institutionalized,http://www.prisonersofthecensus.org/data/2010blocks/281639505002036/
2.82E+14,59,1,0,0,0,0,0,60,33,93,64.51612903,35.48387097,institutionalized,http://www.prisonersofthecensus.org/data/2010blocks/281639505002040/
2.82E+14,1677,53,31,0,123,259,945,3088,578,3666,84.233497,15.766503,institutionalized,http://www.prisonersofthecensus.org/data/2010blocks/281639501003107/
2.82E+14,97,1,0,0,0,0,122,220,62,282,78.0141844,21.9858156,institutionalized,http://www.prisonersofthecensus.org/data/2010blocks/281639501003108/
2.90E+14,3,1,0,0,0,1,1,6,33,39,15.38461538,84.61538462,tract_part,http://www.prisonersofthecensus.org/data/2010blocks/290019503004006/
2.90E+14,0,0,0,0,1,0,1,2,14,16,12.5,87.5,tract_part,http://www.prisonersofthecensus.org/data/2010blocks/290030102005016/
2.90E+14,0,0,0,0,0,0,0,0,8,8,0,100,tract_part,http://www.prisonersofthecensus.org/data/2010blocks/290059502001035/
2.90E+14,388,7,0,1,0,5,34,435,996,1431,30.39832285,69.60167715,tract_part,http://www.prisonersofthecensus.org/data/2010blocks/290079501002087/
2.90E+14,6,1,0,0,0,0,2,9,46,55,16.36363636,83.63636364,tract_part,http://www.prisonersofthecensus.org/data/2010blocks/290079504003098/
2.90E+14,0,1,0,0,1,3,2,7,50,57,12.28070175,87.71929825,tract_part,http://www.prisonersofthecensus.org/data/2010blocks/290099605004081/
2.90E+14,0,0,0,0,0,0,0,0,6,6,0,100,tract_part,http://www.prisonersofthecensus.org/data/2010blocks/290119603001006/
2.90E+14,42,1,0,0,0,0,10,53,31,84,63.0952381,36.9047619,tract_part,http://www.prisonersofthecensus.org/data/2010blocks/290130703004026/
2.90E+14,0,0,0,0,0,0,0,0,18,18,0,100,tract_part,http://www.prisonersofthecensus.org/data/2010blocks/290154603002114/
2.90E+14,0,0,0,0,1,0,1,2,8,10,20,80,tract_part,http://www.prisonersofthecensus.org/data/2010blocks/290179502002064/
2.90E+14,0,0,0,0,0,1,0,1,7,8,12.5,87.5,tract,http://www.prisonersofthecensus.org/data/2010blocks/290190003001008/
2.90E+14,85,0,1,0,2,0,7,95,83,178,53.37078652,46.62921348,institutionalized,http://www.prisonersofthecensus.org/data/2010blocks/290190015033033/
2.90E+14,13,0,0,0,1,0,1,15,57,72,20.83333333,79.16666667,institutionalized,http://www.prisonersofthecensus.org/data/2010blocks/290190015033065/
2.90E+14,3,0,0,0,0,0,3,6,39,45,13.33333333,86.66666667,institutionalized,http://www.prisonersofthecensus.org/data/2010blocks/290210006003014/
2.90E+14,585,5,0,0,0,6,42,638,1411,2049,31.13714007,68.86285993,institutionalized,http://www.prisonersofthecensus.org/data/2010blocks/290210006003022/
2.90E+14,32,0,0,0,1,1,9,43,120,163,26.3803681,73.6196319,tract,http://www.prisonersofthecensus.org/data/2010blocks/290210012002010/
2.90E+14,6,0,0,0,0,0,0,6,26,32,18.75,81.25,institutionalized,http://www.prisonersofthecensus.org/data/2010blocks/290239505001053/
2.90E+14,21,0,0,0,0,0,0,21,58,79,26.58227848,73.41772152,institutionalized,http://www.prisonersofthecensus.org/data/2010blocks/290239505003016/
2.90E+14,19,0,3,0,54,0,56,132,41,173,76.30057803,23.69942197,tract_part,http://www.prisonersofthecensus.org/data/2010blocks/290259502004104/
2.90E+14,255,5,0,0,1,3,20,284,1039,1323,21.46636432,78.53363568,institutionalized,http://www.prisonersofthecensus.org/data/2010blocks/290270703003007/
2.90E+14,16,0,0,0,0,0,1,17,65,82,20.73170732,79.26829268,remaining,http://www.prisonersofthecensus.org/data/2010blocks/290270703005029/
2.90E+14,35,0,2,0,0,0,5,42,135,177,23.72881356,76.27118644,institutionalized,http://www.prisonersofthecensus.org/data/2010blocks/290270703005030/
2.90E+14,0,0,0,0,0,1,0,1,3,4,25,75,tract_part,http://www.prisonersofthecensus.org/data/2010blocks/290299512001007/
2.90E+14,0,0,0,0,0,0,5,5,99,104,4.807692308,95.19230769,tract_part,http://www.prisonersofthecensus.org/data/2010blocks/290299505001055/
2.90E+14,13,0,0,0,0,0,1,14,19,33,42.42424242,57.57575758,tract_part,http://www.prisonersofthecensus.org/data/2010blocks/290318804004004/
2.90E+14,7,0,0,0,0,0,0,7,14,21,33.33333333,66.66666667,tract_part,http://www.prisonersofthecensus.org/data/2010blocks/290318810002023/
2.90E+14,17,0,0,0,1,0,3,21,69,90,23.33333333,76.66666667,tract,http://www.prisonersofthecensus.org/data/2010blocks/290370614001025/
2.90E+14,0,0,0,0,0,0,0,0,7,7,0,100,tract_part,http://www.prisonersofthecensus.org/data/2010blocks/290398703003043/
2.90E+14,0,0,0,0,0,0,0,0,6,6,0,100,tract_part,http://www.prisonersofthecensus.org/data/2010blocks/290414702002168/
2.90E+14,4,0,0,0,7,1,15,27,72,99,27.27272727,72.72727273,tract_part,http://www.prisonersofthecensus.org/data/2010blocks/290430203022057/
2.90E+14,0,0,0,0,0,0,0,0,6,6,0,100,tract_part,http://www.prisonersofthecensus.org/data/2010blocks/290459503001102/
2.90E+14,70,1,3,1,6,1,15,97,203,300,32.33333333,67.66666667,tract,http://www.prisonersofthecensus.org/data/2010blocks/290470214011023/
2.91E+14,18,0,0,0,1,0,1,20,17,37,54.05405405,45.94594595,tract,http://www.prisonersofthecensus.org/data/2010blocks/290510207001059/
2.91E+14,1576,14,1,1,0,6,37,1635,1737,3372,48.48754448,51.51245552,institutionalized,http://www.prisonersofthecensus.org/data/2010blocks/290510201981025/
2.91E+14,39,1,0,0,0,0,1,41,79,120,34.16666667,65.83333333,institutionalized,http://www.prisonersofthecensus.org/data/2010blocks/290510201981027/
2.91E+14,98,0,1,0,0,1,8,108,132,240,45,55,institutionalized,http://www.prisonersofthecensus.org/data/2010blocks/290539502001033/
2.91E+14,465,3,0,0,0,3,16,487,556,1043,46.69223394,53.30776606,institutionalized,http://www.prisonersofthecensus.org/data/2010blocks/290539502001046/
2.91E+14,5,0,0,0,0,0,7,12,72,84,14.28571429,85.71428571,tract_part,http://www.prisonersofthecensus.org/data/2010blocks/290554504004010/
2.91E+14,0,0,0,0,0,0,0,0,4,4,0,100,tract_part,http://www.prisonersofthecensus.org/data/2010blocks/290574801002032/
2.91E+14,0,0,1,0,0,0,1,2,12,14,14.28571429,85.71428571,tract_part,http://www.prisonersofthecensus.org/data/2010blocks/290594802002019/
2.91E+14,8,5,0,0,0,2,9,24,99,123,19.51219512,80.48780488,tract_part,http://www.prisonersofthecensus.org/data/2010blocks/290614701003557/
2.91E+14,676,10,0,2,1,0,39,728,735,1463,49.76076555,50.23923445,institutionalized,http://www.prisonersofthecensus.org/data/2010blocks/290630801005027/
2.91E+14,735,5,0,2,2,13,71,828,1105,1933,42.83497155,57.16502845,institutionalized,http://www.prisonersofthecensus.org/data/2010blocks/290630801005028/
2.91E+14,0,0,0,0,0,0,0,0,6,6,0,100,tract_part,http://www.prisonersofthecensus.org/data/2010blocks/290659603001018/
2.91E+14,0,0,0,0,0,0,0,0,18,18,0,100,tract_part,http://www.prisonersofthecensus.org/data/2010blocks/290679505003043/
2.91E+14,33,1,1,0,1,1,5,42,54,96,43.75,56.25,institutionalized,http://www.prisonersofthecensus.org/data/2010blocks/290693605001015/
2.91E+14,4,0,0,0,0,0,1,5,4,9,55.55555556,44.44444444,institutionalized,http://www.prisonersofthecensus.org/data/2010blocks/290693605002038/
2.91E+14,6,0,0,0,0,0,0,6,28,34,17.64705882,82.35294118,tract_part,http://www.prisonersofthecensus.org/data/2010blocks/290693605001003/
2.91E+14,1,0,0,0,0,0,1,2,10,12,16.66666667,83.33333333,tract_part,http://www.prisonersofthecensus.org/data/2010blocks/290718001003059/
2.91E+14,7,0,0,0,0,1,1,9,87,96,9.375,90.625,tract_part,http://www.prisonersofthecensus.org/data/2010blocks/290718006012034/
2.91E+14,74,9,0,2,11,22,36,154,276,430,35.81395349,64.18604651,tract,http://www.prisonersofthecensus.org/data/2010blocks/290770006003013/
2.91E+14,7,0,0,0,1,2,2,12,85,97,12.37113402,87.62886598,tract_part,http://www.prisonersofthecensus.org/data/2010blocks/290770044002034/
2.91E+14,554,31,3,4,10,13,152,767,404,1171,65.49957301,34.50042699,tract_part,http://www.prisonersofthecensus.org/data/2010blocks/290770058001013/
2.91E+14,1,0,0,0,0,0,1,2,15,17,11.76470588,88.23529412,tract_part,http://www.prisonersofthecensus.org/data/2010blocks/290799603003073/
2.91E+14,2,0,0,0,4,0,4,10,8,18,55.55555556,44.44444444,tract_part,http://www.prisonersofthecensus.org/data/2010blocks/290819503002008/
2.91E+14,0,0,0,0,0,0,1,1,20,21,4.761904762,95.23809524,tract_part,http://www.prisonersofthecensus.org/data/2010blocks/290839505002031/
2.91E+14,0,0,0,0,0,0,0,0,9,9,0,100,tract_part,http://www.prisonersofthecensus.org/data/2010blocks/290854703001056/
2.91E+14,0,1,0,0,0,0,0,1,9,10,10,90,tract_part,http://www.prisonersofthecensus.org/data/2010blocks/290879603002049/
2.91E+14,0,0,0,0,0,0,0,0,6,6,0,100,tract_part,http://www.prisonersofthecensus.org/data/2010blocks/290899603002038/
2.91E+14,0,0,0,0,0,1,0,1,1,2,50,50,institutionalized,http://www.prisonersofthecensus.org/data/2010blocks/290910908003011/
2.91E+14,10,0,1,0,1,2,7,21,25,46,45.65217391,54.34782609,institutionalized,http://www.prisonersofthecensus.org/data/2010blocks/290910908003017/
2.91E+14,2,0,0,0,0,0,0,2,15,17,11.76470588,88.23529412,tract_part,http://www.prisonersofthecensus.org/data/2010blocks/290939503001067/
2.91E+14,1,0,0,1,0,3,4,9,7,16,56.25,43.75,tract,http://www.prisonersofthecensus.org/data/2010blocks/290950011002010/
2.91E+14,1,0,0,0,0,0,0,1,1,2,50,50,tract,http://www.prisonersofthecensus.org/data/2010blocks/290950018003016/
2.91E+14,87,2,1,0,0,1,5,96,200,296,32.43243243,67.56756757,tract,http://www.prisonersofthecensus.org/data/2010blocks/290950152001096/
2.91E+14,37,0,0,0,0,0,3,40,102,142,28.16901408,71.83098592,tract,http://www.prisonersofthecensus.org/data/2010blocks/290950158002022/
2.91E+14,505,0,3,0,33,1,37,579,196,775,74.70967742,25.29032258,tract,http://www.prisonersofthecensus.org/data/2010blocks/290950159001070/
2.91E+14,11,0,0,0,0,0,0,11,58,69,15.94202899,84.05797101,tract,http://www.prisonersofthecensus.org/data/2010blocks/290970101001060/
2.91E+14,24,5,0,2,13,7,26,77,139,216,35.64814815,64.35185185,tract_part,http://www.prisonersofthecensus.org/data/2010blocks/290970116004038/
2.91E+14,30,0,0,0,0,0,6,36,218,254,14.17322835,85.82677165,tract_part,http://www.prisonersofthecensus.org/data/2010blocks/290997005024108/
2.91E+14,22,0,0,0,1,0,10,33,41,74,44.59459459,55.40540541,tract_part,http://www.prisonersofthecensus.org/data/2010blocks/291019602001122/
2.91E+14,2,0,0,0,0,1,2,5,32,37,13.51351351,86.48648649,tract_part,http://www.prisonersofthecensus.org/data/2010blocks/291019606004034/
2.91E+14,2,5,1,1,0,7,5,21,87,108,19.44444444,80.55555556,tract_part,http://www.prisonersofthecensus.org/data/2010blocks/291059604004015/
2.91E+14,49,1,0,0,0,0,16,66,37,103,64.0776699,35.9223301,tract_part,http://www.prisonersofthecensus.org/data/2010blocks/291070901005002/
2.91E+14,0,0,0,0,0,0,0,0,27,27,0,100,tract_part,http://www.prisonersofthecensus.org/data/2010blocks/291094702006016/
2.91E+14,1,0,0,0,0,0,0,1,7,8,12.5,87.5,tract_part,http://www.prisonersofthecensus.org/data/2010blocks/291119703001052/
2.91E+14,23,0,0,0,0,0,4,27,38,65,41.53846154,58.46153846,tract_part,http://www.prisonersofthecensus.org/data/2010blocks/291138103012004/
2.91E+14,1,0,0,0,0,0,0,1,38,39,2.564102564,97.43589744,tract_part,http://www.prisonersofthecensus.org/data/2010blocks/291174804002008/
2.91E+14,227,7,3,0,0,1,24,262,709,971,26.98249228,73.01750772,tract_part,http://www.prisonersofthecensus.org/data/2010blocks/291174801001267/
2.91E+14,0,5,0,0,3,0,6,14,26,40,35,65,tract_part,http://www.prisonersofthecensus.org/data/2010blocks/291190704002006/
2.91E+14,0,0,0,0,0,0,2,2,15,17,11.76470588,88.23529412,tract_part,http://www.prisonersofthecensus.org/data/2010blocks/291239602002110/
2.91E+14,25,0,0,0,0,0,5,30,68,98,30.6122449,69.3877551,tract_part,http://www.prisonersofthecensus.org/data/2010blocks/291279601002080/
2.91E+14,1,0,0,0,0,0,0,1,20,21,4.761904762,95.23809524,tract_part,http://www.prisonersofthecensus.org/data/2010blocks/291279608002066/
2.91E+14,5,1,0,0,1,0,9,16,48,64,25,75,tract_part,http://www.prisonersofthecensus.org/data/2010blocks/291319628001052/
2.91E+14,1004,0,0,0,0,9,17,1030,579,1609,64.0149161,35.9850839,tract_part,http://www.prisonersofthecensus.org/data/2010blocks/291339501003053/
2.91E+14,28,0,5,0,14,1,42,90,41,131,68.70229008,31.29770992,tract_part,http://www.prisonersofthecensus.org/data/2010blocks/291339502001039/
2.91E+14,510,4,0,1,0,6,13,534,619,1153,46.31396357,53.68603643,tract_part,http://www.prisonersofthecensus.org/data/2010blocks/291353854003002/
2.91E+14,0,0,0,0,0,0,0,0,4,4,0,100,tract_part,http://www.prisonersofthecensus.org/data/2010blocks/291379602004022/
2.91E+14,6,0,1,0,36,0,41,84,37,121,69.4214876,30.5785124,tract_part,http://www.prisonersofthecensus.org/data/2010blocks/291399702002049/
2.91E+14,12,1,1,0,10,2,26,52,39,91,57.14285714,42.85714286,tract_part,http://www.prisonersofthecensus.org/data/2010blocks/291414703002000/
2.91E+14,21,0,0,0,0,1,1,23,22,45,51.11111111,48.88888889,tract_part,http://www.prisonersofthecensus.org/data/2010blocks/291439603003048/
2.91E+14,5,1,2,4,2,2,5,21,76,97,21.64948454,78.35051546,tract_part,http://www.prisonersofthecensus.org/data/2010blocks/291450203003052/
2.91E+14,2,0,0,0,0,0,2,4,25,29,13.79310345,86.20689655,tract_part,http://www.prisonersofthecensus.org/data/2010blocks/291474704004019/
2.91E+14,161,0,0,0,0,1,7,169,342,511,33.07240705,66.92759295,tract_part,http://www.prisonersofthecensus.org/data/2010blocks/291474705003083/
2.91E+14,0,0,0,0,0,0,0,0,12,12,0,100,tract_part,http://www.prisonersofthecensus.org/data/2010blocks/291494801001048/
2.92E+14,1,0,0,0,0,0,0,1,115,116,0.862068966,99.13793103,tract_part,http://www.prisonersofthecensus.org/data/2010blocks/291514902002004/
2.92E+14,17,0,0,0,0,0,14,31,5,36,86.11111111,13.88888889,tract_part,http://www.prisonersofthecensus.org/data/2010blocks/291554704003018/
2.92E+14,2,0,0,0,0,1,2,5,24,29,17.24137931,82.75862069,tract_part,http://www.prisonersofthecensus.org/data/2010blocks/291574703002024/
2.92E+14,31,0,0,0,5,1,6,43,69,112,38.39285714,61.60714286,tract,http://www.prisonersofthecensus.org/data/2010blocks/291594809002030/
2.92E+14,23,0,0,0,3,0,5,31,94,125,24.8,75.2,tract_part,http://www.prisonersofthecensus.org/data/2010blocks/291618908003011/
2.92E+14,756,5,1,0,1,5,53,821,1108,1929,42.56091239,57.43908761,tract_part,http://www.prisonersofthecensus.org/data/2010blocks/291634603001087/
2.92E+14,6,0,0,0,0,0,0,6,28,34,17.64705882,82.35294118,tract_part,http://www.prisonersofthecensus.org/data/2010blocks/291634604001021/
2.92E+14,21,0,0,0,5,0,5,31,46,77,40.25974026,59.74025974,tract_part,http://www.prisonersofthecensus.org/data/2010blocks/291650305001030/
2.92E+14,0,2,0,0,0,1,1,4,22,26,15.38461538,84.61538462,tract_part,http://www.prisonersofthecensus.org/data/2010blocks/291679603002031/
2.92E+14,5,0,0,0,3,0,4,12,12,24,50,50,tract_part,http://www.prisonersofthecensus.org/data/2010blocks/291694704001065/
2.92E+14,515,5,0,0,1,3,24,548,1167,1715,31.95335277,68.04664723,tract_part,http://www.prisonersofthecensus.org/data/2010blocks/291754906001060/
2.92E+14,21,0,0,0,0,0,1,22,54,76,28.94736842,71.05263158,tract_part,http://www.prisonersofthecensus.org/data/2010blocks/291754902003044/
2.92E+14,0,0,0,0,0,0,0,0,3,3,0,100,tract_part,http://www.prisonersofthecensus.org/data/2010blocks/291754905001034/
2.92E+14,20,0,0,0,1,1,2,24,58,82,29.26829268,70.73170732,tract_part,http://www.prisonersofthecensus.org/data/2010blocks/291770801001033/
2.92E+14,1,0,0,0,0,1,0,2,9,11,18.18181818,81.81818182,tract_part,http://www.prisonersofthecensus.org/data/2010blocks/291793801001448/
2.92E+14,94,4,3,0,1,10,15,127,237,364,34.89010989,65.10989011,tract_part,http://www.prisonersofthecensus.org/data/2010blocks/291833105021057/
2.92E+14,15,0,0,0,3,0,7,25,69,94,26.59574468,73.40425532,institutionalized,http://www.prisonersofthecensus.org/data/2010blocks/291854803002059/
2.92E+14,0,0,0,0,0,0,0,0,8,8,0,100,institutionalized,http://www.prisonersofthecensus.org/data/2010blocks/291854803002093/
2.92E+14,30,0,0,0,1,0,6,37,33,70,52.85714286,47.14285714,tract_part,http://www.prisonersofthecensus.org/data/2010blocks/291869602003065/
2.92E+14,1246,3,1,2,1,9,50,1312,1265,2577,50.91191308,49.08808692,tract_part,http://www.prisonersofthecensus.org/data/2010blocks/291879503001007/
2.92E+14,34,0,0,1,0,0,10,45,175,220,20.45454545,79.54545455,tract_part,http://www.prisonersofthecensus.org/data/2010blocks/291879504003140/
2.92E+14,871,6,0,3,1,9,64,954,1675,2629,36.28756181,63.71243819,tract_part,http://www.prisonersofthecensus.org/data/2010blocks/291879509024003/
2.92E+14,761,11,1,0,7,26,27,833,401,1234,67.50405186,32.49594814,tract,http://www.prisonersofthecensus.org/data/2010blocks/291892165003005/
2.92E+14,4,0,0,0,0,0,0,4,0,4,100,0,tract_part,http://www.prisonersofthecensus.org/data/2010blocks/291892111021000/
2.92E+14,471,2,0,1,1,1,8,484,601,1085,44.60829493,55.39170507,tract_part,http://www.prisonersofthecensus.org/data/2010blocks/291892215031033/
2.92E+14,28,0,0,0,0,1,5,34,7,41,82.92682927,17.07317073,tract_part,http://www.prisonersofthecensus.org/data/2010blocks/291892121014006/
2.92E+14,9,0,0,2,2,1,2,16,32,48,33.33333333,66.66666667,tract_part,http://www.prisonersofthecensus.org/data/2010blocks/291950903003014/
2.92E+14,0,0,0,0,0,0,0,0,2,2,0,100,tract_part,http://www.prisonersofthecensus.org/data/2010blocks/291994802001008/
2.92E+14,39,0,0,0,0,1,8,48,52,100,48,52,tract_part,http://www.prisonersofthecensus.org/data/2010blocks/292017810003056/
2.92E+14,0,0,0,0,0,2,1,3,4,7,42.85714286,57.14285714,tract_part,http://www.prisonersofthecensus.org/data/2010blocks/292034701004029/
2.92E+14,0,0,0,0,0,0,0,0,7,7,0,100,tract_part,http://www.prisonersofthecensus.org/data/2010blocks/292054501002044/
2.92E+14,1,1,0,0,0,0,1,3,55,58,5.172413793,94.82758621,tract_part,http://www.prisonersofthecensus.org/data/2010blocks/292074703003004/
2.92E+14,0,0,0,0,0,0,0,0,2,2,0,100,tract_part,http://www.prisonersofthecensus.org/data/2010blocks/292134802015030/
2.92E+14,3,7,0,0,6,6,14,36,74,110,32.72727273,67.27272727,tract_part,http://www.prisonersofthecensus.org/data/2010blocks/292134804014057/
2.92E+14,1,0,0,0,0,0,1,2,43,45,4.444444444,95.55555556,tract_part,http://www.prisonersofthecensus.org/data/2010blocks/292154803006012/
2.92E+14,798,4,0,1,1,2,41,847,755,1602,52.87141074,47.12858926,tract_part,http://www.prisonersofthecensus.org/data/2010blocks/292154801003102/
2.92E+14,2,0,0,0,0,0,0,2,46,48,4.166666667,95.83333333,tract_part,http://www.prisonersofthecensus.org/data/2010blocks/292179504002060/
2.92E+14,30,0,0,0,0,0,29,59,59,118,50,50,tract_part,http://www.prisonersofthecensus.org/data/2010blocks/292198201023018/
2.92E+14,0,0,0,0,0,0,0,0,27,27,0,100,tract_part,http://www.prisonersofthecensus.org/data/2010blocks/292214603003036/
2.92E+14,426,1,0,2,0,11,18,458,444,902,50.77605322,49.22394678,tract_part,http://www.prisonersofthecensus.org/data/2010blocks/292214603001066/
2.92E+14,1,0,0,0,0,0,0,1,13,14,7.142857143,92.85714286,tract_part,http://www.prisonersofthecensus.org/data/2010blocks/292236902002108/
2.92E+14,217,1,0,0,0,1,5,224,407,631,35.49920761,64.50079239,tract_part,http://www.prisonersofthecensus.org/data/2010blocks/292254704022038/
2.92E+14,2,0,0,0,0,4,4,10,18,28,35.71428571,64.28571429,tract_part,http://www.prisonersofthecensus.org/data/2010blocks/292254702012069/
2.92E+14,0,0,0,0,0,0,0,0,23,23,0,100,tract_part,http://www.prisonersofthecensus.org/data/2010blocks/292294902004065/
2.95E+14,140,0,0,0,0,0,0,140,48,188,74.46808511,25.53191489,tract,http://www.prisonersofthecensus.org/data/2010blocks/295101065002001/
2.95E+14,27,0,1,0,0,0,0,28,47,75,37.33333333,62.66666667,tract,http://www.prisonersofthecensus.org/data/2010blocks/295101255001010/
2.95E+14,515,0,2,0,0,1,3,521,53,574,90.76655052,9.233449477,tract,http://www.prisonersofthecensus.org/data/2010blocks/295101256003060/
2.95E+14,274,2,0,0,0,2,0,278,187,465,59.78494624,40.21505376,tract,http://www.prisonersofthecensus.org/data/2010blocks/295101266002057/
3.00E+14,0,0,0,0,0,0,0,0,5,5,0,100,tract_part,http://www.prisonersofthecensus.org/data/2010blocks/300010003002084/
3.00E+14,0,22,0,0,0,0,0,22,7,29,75.86206897,24.13793103,tract_part,http://www.prisonersofthecensus.org/data/2010blocks/300030001001098/
3.00E+14,0,10,0,0,0,0,0,10,0,10,100,0,tract_part,http://www.prisonersofthecensus.org/data/2010blocks/300059401001041/
3.00E+14,1,7,0,0,0,0,1,9,17,26,34.61538462,65.38461538,tract_part,http://www.prisonersofthecensus.org/data/2010blocks/300070001001063/
3.00E+14,3,71,0,0,11,0,11,96,151,247,38.86639676,61.13360324,tract_part,http://www.prisonersofthecensus.org/data/2010blocks/300130003001006/
3.00E+14,0,11,0,0,0,5,0,16,1,17,94.11764706,5.882352941,tract,http://www.prisonersofthecensus.org/data/2010blocks/300130008001001/
3.00E+14,14,71,3,0,15,0,16,119,140,259,45.94594595,54.05405405,tract_part,http://www.prisonersofthecensus.org/data/2010blocks/300130107001051/
3.00E+14,0,0,0,0,0,1,0,1,4,5,20,80,tract_part,http://www.prisonersofthecensus.org/data/2010blocks/300150102002089/
3.00E+14,0,3,0,0,0,1,0,4,9,13,30.76923077,69.23076923,tract_part,http://www.prisonersofthecensus.org/data/2010blocks/300179620002037/
3.00E+14,6,40,0,0,4,9,8,67,107,174,38.50574713,61.49425287,remaining,http://www.prisonersofthecensus.org/data/2010blocks/300210003001005/
3.00E+14,0,2,0,0,2,1,3,8,48,56,14.28571429,85.71428571,institutionalized,http://www.prisonersofthecensus.org/data/2010blocks/300210003001053/
3.00E+14,1,7,0,0,0,2,3,13,14,27,48.14814815,51.85185185,tract,http://www.prisonersofthecensus.org/data/2010blocks/300230003001105/
3.00E+14,2,26,0,0,0,0,4,32,60,92,34.7826087,65.2173913,institutionalized,http://www.prisonersofthecensus.org/data/2010blocks/300230005001134/
3.00E+14,1,39,0,0,2,2,8,52,121,173,30.05780347,69.94219653,institutionalized,http://www.prisonersofthecensus.org/data/2010blocks/300230005001207/
3.00E+14,0,0,0,0,0,0,0,0,3,3,0,100,tract_part,http://www.prisonersofthecensus.org/data/2010blocks/300250001003107/
3.00E+14,0,15,0,0,0,0,3,18,69,87,20.68965517,79.31034483,tract_part,http://www.prisonersofthecensus.org/data/2010blocks/300270301003407/
3.00E+14,0,1,0,0,1,0,1,3,4,7,42.85714286,57.14285714,tract_part,http://www.prisonersofthecensus.org/data/2010blocks/300270302002153/
3.00E+14,0,0,0,0,0,0,0,0,4,4,0,100,tract_part,http://www.prisonersofthecensus.org/data/2010blocks/300290002012013/
3.00E+14,2,5,0,0,0,4,1,12,64,76,15.78947368,84.21052632,tract,http://www.prisonersofthecensus.org/data/2010blocks/300290010001065/
3.00E+14,1,1,1,0,0,1,1,5,45,50,10,90,tract,http://www.prisonersofthecensus.org/data/2010blocks/300310009002008/
3.00E+14,0,8,0,0,0,0,0,8,14,22,36.36363636,63.63636364,tract_part,http://www.prisonersofthecensus.org/data/2010blocks/300359402001052/
3.00E+14,1,8,0,0,0,0,0,9,2,11,81.81818182,18.18181818,tract_part,http://www.prisonersofthecensus.org/data/2010blocks/300359760003075/
3.00E+14,0,0,0,0,0,0,0,0,1,1,0,100,tract_part,http://www.prisonersofthecensus.org/data/2010blocks/300399617003111/
3.00E+14,1,14,0,0,1,0,2,18,13,31,58.06451613,41.93548387,tract_part,http://www.prisonersofthecensus.org/data/2010blocks/300410404001000/
3.00E+14,0,1,0,0,4,1,5,11,7,18,61.11111111,38.88888889,institutionalized,http://www.prisonersofthecensus.org/data/2010blocks/300439622021067/
3.00E+14,0,3,0,0,0,0,0,3,8,11,27.27272727,72.72727273,institutionalized,http://www.prisonersofthecensus.org/data/2010blocks/300439622024062/
3.00E+14,0,3,0,0,0,4,0,7,7,14,50,50,institutionalized,http://www.prisonersofthecensus.org/data/2010blocks/300439622024016/
3.00E+14,0,11,1,0,0,4,4,20,24,44,45.45454545,54.54545455,remaining,http://www.prisonersofthecensus.org/data/2010blocks/300439622024098/
3.00E+14,0,7,0,0,0,0,1,8,0,8,100,0,tract_part,http://www.prisonersofthecensus.org/data/2010blocks/300479404002056/
3.00E+14,0,17,0,0,0,3,3,23,13,36,63.88888889,36.11111111,tract_part,http://www.prisonersofthecensus.org/data/2010blocks/300479403012066/
3.00E+14,0,0,0,0,0,0,0,0,4,4,0,100,tract_part,http://www.prisonersofthecensus.org/data/2010blocks/300470002001059/
3.00E+14,0,2,0,0,1,3,5,11,21,32,34.375,65.625,tract_part,http://www.prisonersofthecensus.org/data/2010blocks/300490008004027/
3.00E+14,0,12,0,0,0,1,1,14,77,91,15.38461538,84.61538462,tract_part,http://www.prisonersofthecensus.org/data/2010blocks/300490011004031/
3.01E+14,0,1,0,0,1,0,1,3,18,21,14.28571429,85.71428571,tract_part,http://www.prisonersofthecensus.org/data/2010blocks/300530002001048/
3.01E+14,0,0,0,0,0,0,0,0,4,4,0,100,tract_part,http://www.prisonersofthecensus.org/data/2010blocks/300619646002210/
3.01E+14,10,49,2,0,0,3,8,72,231,303,23.76237624,76.23762376,tract_part,http://www.prisonersofthecensus.org/data/2010blocks/300630002011061/
3.01E+14,0,0,0,0,1,0,1,2,1,3,66.66666667,33.33333333,tract_part,http://www.prisonersofthecensus.org/data/2010blocks/300650002002063/
3.01E+14,0,0,0,0,0,0,0,0,14,14,0,100,tract_part,http://www.prisonersofthecensus.org/data/2010blocks/300670003003030/
3.01E+14,0,2,0,0,0,0,0,2,6,8,25,75,tract_part,http://www.prisonersofthecensus.org/data/2010blocks/300739770005049/
3.01E+14,0,0,0,0,0,0,0,0,7,7,0,100,tract_part,http://www.prisonersofthecensus.org/data/2010blocks/300770002004075/
3.01E+14,39,249,2,0,24,6,50,370,1103,1473,25.11880516,74.88119484,tract_part,http://www.prisonersofthecensus.org/data/2010blocks/300770002006005/
3.01E+14,0,0,0,0,0,0,0,0,3,3,0,100,tract_part,http://www.prisonersofthecensus.org/data/2010blocks/300810007002024/
3.01E+14,0,0,0,0,0,0,0,0,2,2,0,100,institutionalized,http://www.prisonersofthecensus.org/data/2010blocks/300810005004031/
3.01E+14,1,0,0,0,0,0,2,3,37,40,7.5,92.5,institutionalized,http://www.prisonersofthecensus.org/data/2010blocks/300810005005028/
3.01E+14,1,4,0,0,0,0,0,5,4,9,55.55555556,44.44444444,tract_part,http://www.prisonersofthecensus.org/data/2010blocks/300859400015010/
3.01E+14,0,26,0,0,0,0,2,28,0,28,100,0,tract_part,http://www.prisonersofthecensus.org/data/2010blocks/300859400024000/
3.01E+14,0,3,0,0,2,0,2,7,4,11,63.63636364,36.36363636,tract_part,http://www.prisonersofthecensus.org/data/2010blocks/300870001002181/
3.01E+14,0,21,0,0,0,0,0,21,0,21,100,0,tract_part,http://www.prisonersofthecensus.org/data/2010blocks/300879404001079/
3.01E+14,1,2,0,0,0,0,0,3,9,12,25,75,tract_part,http://www.prisonersofthecensus.org/data/2010blocks/300890002005061/
3.01E+14,0,0,0,0,0,0,0,0,1,1,0,100,tract_part,http://www.prisonersofthecensus.org/data/2010blocks/300910902001010/
3.01E+14,2,9,0,0,0,2,4,17,49,66,25.75757576,74.24242424,institutionalized,http://www.prisonersofthecensus.org/data/2010blocks/300930001004010/
3.01E+14,6,51,0,0,8,6,17,88,127,215,40.93023256,59.06976744,institutionalized,http://www.prisonersofthecensus.org/data/2010blocks/300930001004020/
3.01E+14,0,0,0,0,0,0,0,0,6,6,0,100,tract_part,http://www.prisonersofthecensus.org/data/2010blocks/301010002002030/
3.01E+14,17,121,4,0,20,1,39,202,442,644,31.36645963,68.63354037,tract,http://www.prisonersofthecensus.org/data/2010blocks/301019800001000/
3.01E+14,0,3,0,0,0,2,0,5,2,7,71.42857143,28.57142857,tract_part,http://www.prisonersofthecensus.org/data/2010blocks/301051005002096/
3.01E+14,3,54,0,0,4,0,6,67,94,161,41.61490683,58.38509317,institutionalized,http://www.prisonersofthecensus.org/data/2010blocks/301110003001031/
3.01E+14,4,49,0,0,4,0,5,62,102,164,37.80487805,62.19512195,institutionalized,http://www.prisonersofthecensus.org/data/2010blocks/301110003002009/
3.01E+14,6,50,0,0,6,4,24,90,126,216,41.66666667,58.33333333,tract,http://www.prisonersofthecensus.org/data/2010blocks/301110004023044/
3.01E+14,22,85,0,0,39,2,42,190,222,412,46.11650485,53.88349515,tract_part,http://www.prisonersofthecensus.org/data/2010blocks/301110009021049/
3.10E+14,2,0,0,0,0,0,2,4,24,28,14.28571429,85.71428571,tract,http://www.prisonersofthecensus.org/data/2010blocks/310019657001029/
3.10E+14,1,0,0,0,0,0,0,1,5,6,16.66666667,83.33333333,tract_part,http://www.prisonersofthecensus.org/data/2010blocks/310039797002116/
3.10E+14,0,1,0,0,0,0,0,1,1,2,50,50,tract_part,http://www.prisonersofthecensus.org/data/2010blocks/310119602001080/
3.10E+14,1,3,0,0,1,0,3,8,5,13,61.53846154,38.46153846,tract_part,http://www.prisonersofthecensus.org/data/2010blocks/310139513002058/
3.10E+14,8,0,0,0,0,0,35,43,53,96,44.79166667,55.20833333,tract_part,http://www.prisonersofthecensus.org/data/2010blocks/310199697002018/
3.10E+14,6,0,0,0,0,0,1,7,23,30,23.33333333,76.66666667,tract_part,http://www.prisonersofthecensus.org/data/2010blocks/310239677002071/
3.10E+14,14,2,0,0,6,6,30,58,43,101,57.42574257,42.57425743,tract_part,http://www.prisonersofthecensus.org/data/2010blocks/310259656004025/
3.10E+14,0,0,0,0,0,0,0,0,4,4,0,100,tract_part,http://www.prisonersofthecensus.org/data/2010blocks/310279771005133/
3.10E+14,0,2,0,0,0,0,0,2,1,3,66.66666667,33.33333333,tract_part,http://www.prisonersofthecensus.org/data/2010blocks/310319558004013/
3.10E+14,0,0,0,0,0,0,0,0,7,7,0,100,tract_part,http://www.prisonersofthecensus.org/data/2010blocks/310339550001140/
3.10E+14,1,0,0,0,0,0,0,1,4,5,20,80,tract_part,http://www.prisonersofthecensus.org/data/2010blocks/310359622001113/
3.10E+14,0,1,0,0,0,0,1,2,4,6,33.33333333,66.66666667,tract_part,http://www.prisonersofthecensus.org/data/2010blocks/310419719003002/
3.10E+14,5,17,0,0,4,4,17,47,26,73,64.38356164,35.61643836,tract_part,http://www.prisonersofthecensus.org/data/2010blocks/310430103003157/
3.10E+14,1,6,0,0,1,0,1,9,8,17,52.94117647,47.05882353,tract_part,http://www.prisonersofthecensus.org/data/2010blocks/310459507002028/
3.10E+14,13,1,1,0,6,6,34,61,43,104,58.65384615,41.34615385,tract_part,http://www.prisonersofthecensus.org/data/2010blocks/310479685005018/
3.11E+14,0,0,0,0,0,1,2,3,5,8,37.5,62.5,tract_part,http://www.prisonersofthecensus.org/data/2010blocks/310519776001109/
3.11E+14,7,1,0,0,2,0,10,20,26,46,43.47826087,56.52173913,tract_part,http://www.prisonersofthecensus.org/data/2010blocks/310539642003033/
3.11E+14,36,4,0,0,2,0,20,62,28,90,68.88888889,31.11111111,institutionalized,http://www.prisonersofthecensus.org/data/2010blocks/310550005002051/
3.11E+14,139,15,4,1,9,0,90,258,359,617,41.81523501,58.18476499,institutionalized,http://www.prisonersofthecensus.org/data/2010blocks/310550005002054/
3.11E+14,60,3,0,0,2,0,13,78,75,153,50.98039216,49.01960784,institutionalized,http://www.prisonersofthecensus.org/data/2010blocks/310550005002055/
3.11E+14,528,17,9,0,12,7,260,833,502,1335,62.39700375,37.60299625,tract,http://www.prisonersofthecensus.org/data/2010blocks/310550018001032/
3.11E+14,0,0,0,0,0,0,0,0,3,3,0,100,tract,http://www.prisonersofthecensus.org/data/2010blocks/310550032001018/
3.11E+14,0,1,0,0,0,0,0,1,3,4,25,75,tract,http://www.prisonersofthecensus.org/data/2010blocks/310550033001002/
3.11E+14,0,0,0,0,0,0,6,6,0,6,100,0,tract_part,http://www.prisonersofthecensus.org/data/2010blocks/310590917003045/
3.11E+14,0,0,0,0,1,0,1,2,0,2,100,0,tract_part,http://www.prisonersofthecensus.org/data/2010blocks/310619647001315/
3.11E+14,0,0,0,0,0,0,0,0,3,3,0,100,tract_part,http://www.prisonersofthecensus.org/data/2010blocks/310639611003123/
3.11E+14,1,0,0,0,0,0,0,1,1,2,50,50,tract_part,http://www.prisonersofthecensus.org/data/2010blocks/310659639006229/
3.11E+14,1,2,0,0,0,0,1,4,21,25,16,84,tract,http://www.prisonersofthecensus.org/data/2010blocks/310679650003036/
3.11E+14,24,5,2,0,0,2,111,144,81,225,64,36,tract_part,http://www.prisonersofthecensus.org/data/2010blocks/310790010003049/
3.11E+14,0,0,0,0,0,0,0,0,9,9,0,100,tract_part,http://www.prisonersofthecensus.org/data/2010blocks/310819693003027/
3.11E+14,0,0,0,0,0,0,0,0,3,3,0,100,tract_part,http://www.prisonersofthecensus.org/data/2010blocks/310839642002134/
3.11E+14,0,0,0,0,0,0,1,1,3,4,25,75,tract_part,http://www.prisonersofthecensus.org/data/2010blocks/310879627003087/
3.11E+14,0,0,0,0,1,0,1,2,2,4,50,50,tract_part,http://www.prisonersofthecensus.org/data/2010blocks/310899743004042/
3.11E+14,0,0,0,1,1,0,1,3,6,9,33.33333333,66.66666667,tract_part,http://www.prisonersofthecensus.org/data/2010blocks/310959638001108/
3.11E+14,269,52,5,0,1,1,118,446,459,905,49.28176796,50.71823204,tract_part,http://www.prisonersofthecensus.org/data/2010blocks/310979676001010/
3.11E+14,0,1,0,0,3,0,4,8,0,8,100,0,tract_part,http://www.prisonersofthecensus.org/data/2010blocks/310999667002089/
3.11E+14,0,0,0,0,0,0,2,2,6,8,25,75,tract,http://www.prisonersofthecensus.org/data/2010blocks/311010001001036/
3.11E+14,0,0,0,0,0,0,2,2,4,6,33.33333333,66.66666667,tract_part,http://www.prisonersofthecensus.org/data/2010blocks/311059545003015/
3.11E+14,0,0,0,0,0,0,5,5,1,6,83.33333333,16.66666667,tract_part,http://www.prisonersofthecensus.org/data/2010blocks/311079762002417/
3.11E+14,0,0,2,0,0,3,1,6,47,53,11.32075472,88.67924528,tract,http://www.prisonersofthecensus.org/data/2010blocks/311090007002023/
3.11E+14,96,3,4,0,8,3,23,137,174,311,44.05144695,55.94855305,tract,http://www.prisonersofthecensus.org/data/2010blocks/311090020023004/
3.11E+14,269,57,9,0,4,4,132,475,743,1218,38.99835796,61.00164204,tract_part,http://www.prisonersofthecensus.org/data/2010blocks/311090034011013/
3.11E+14,311,51,8,0,73,4,154,601,603,1204,49.91694352,50.08305648,tract,http://www.prisonersofthecensus.org/data/2010blocks/311090036011000/
3.11E+14,30,4,1,0,4,1,13,53,112,165,32.12121212,67.87878788,tract_part,http://www.prisonersofthecensus.org/data/2010blocks/311099832001097/
3.11E+14,2,0,0,0,1,0,11,14,45,59,23.72881356,76.27118644,tract_part,http://www.prisonersofthecensus.org/data/2010blocks/311119602002045/
3.11E+14,3,7,0,0,7,1,23,41,34,75,54.66666667,45.33333333,tract_part,http://www.prisonersofthecensus.org/data/2010blocks/311199613004061/
3.11E+14,0,2,0,0,0,0,3,5,5,10,50,50,tract_part,http://www.prisonersofthecensus.org/data/2010blocks/311219668001072/
3.11E+14,0,0,0,0,0,0,2,2,2,4,50,50,tract_part,http://www.prisonersofthecensus.org/data/2010blocks/311239525005103/
3.11E+14,1,0,1,0,0,0,1,3,10,13,23.07692308,76.92307692,tract_part,http://www.prisonersofthecensus.org/data/2010blocks/311279682003056/
3.11E+14,1,2,0,0,0,0,2,5,7,12,41.66666667,58.33333333,tract_part,http://www.prisonersofthecensus.org/data/2010blocks/311319670001118/
3.11E+14,2,0,0,0,10,4,32,48,14,62,77.41935484,22.58064516,tract_part,http://www.prisonersofthecensus.org/data/2010blocks/311379670001064/
3.11E+14,0,0,0,0,0,0,9,9,3,12,75,25,tract_part,http://www.prisonersofthecensus.org/data/2010blocks/311399791002090/
3.11E+14,12,15,0,0,1,2,33,63,48,111,56.75675676,43.24324324,tract_part,http://www.prisonersofthecensus.org/data/2010blocks/311419655002018/
3.11E+14,0,0,0,0,0,0,0,0,1,1,0,100,tract_part,http://www.prisonersofthecensus.org/data/2010blocks/311439600002096/
3.11E+14,39,7,1,0,14,1,17,79,94,173,45.66473988,54.33526012,tract_part,http://www.prisonersofthecensus.org/data/2010blocks/311459632002005/
3.11E+14,0,1,0,0,0,0,1,2,5,7,28.57142857,71.42857143,tract_part,http://www.prisonersofthecensus.org/data/2010blocks/311479686003115/
3.12E+14,25,1,1,0,1,2,77,107,1,108,99.07407407,0.925925926,tract_part,http://www.prisonersofthecensus.org/data/2010blocks/311519609002036/
3.12E+14,34,0,0,0,0,1,25,60,99,159,37.73584906,62.26415094,tract_part,http://www.prisonersofthecensus.org/data/2010blocks/311530106193015/
3.12E+14,22,6,2,0,3,12,27,72,48,120,60,40,tract_part,http://www.prisonersofthecensus.org/data/2010blocks/311559683003039/
3.12E+14,5,16,1,0,7,2,50,81,47,128,63.28125,36.71875,tract_part,http://www.prisonersofthecensus.org/data/2010blocks/311579538001039/
3.12E+14,1,0,0,0,1,1,2,5,14,19,26.31578947,73.68421053,tract_part,http://www.prisonersofthecensus.org/data/2010blocks/311599602001050/
3.12E+14,0,3,0,0,1,0,2,6,3,9,66.66666667,33.33333333,tract_part,http://www.prisonersofthecensus.org/data/2010blocks/311619517003056/
3.12E+14,0,0,0,0,0,0,0,0,3,3,0,100,tract_part,http://www.prisonersofthecensus.org/data/2010blocks/311699632001052/
3.12E+14,0,2,0,0,0,1,0,3,4,7,42.85714286,57.14285714,tract_part,http://www.prisonersofthecensus.org/data/2010blocks/311739401003071/
3.12E+14,0,0,0,0,0,0,0,0,5,5,0,100,tract_part,http://www.prisonersofthecensus.org/data/2010blocks/311759714003038/
3.12E+14,0,1,0,0,0,0,1,2,21,23,8.695652174,91.30434783,tract_part,http://www.prisonersofthecensus.org/data/2010blocks/311770501024068/
3.12E+14,0,0,0,0,1,0,2,3,3,6,50,50,tract_part,http://www.prisonersofthecensus.org/data/2010blocks/311819651002094/
3.12E+14,60,16,0,0,10,10,31,127,168,295,43.05084746,56.94915254,tract_part,http://www.prisonersofthecensus.org/data/2010blocks/311859698002080/
3.12E+14,2,0,0,0,0,0,6,8,12,20,40,60,tract_part,http://www.prisonersofthecensus.org/data/2010blocks/311859698001083/
3.20E+14,0,7,1,0,0,0,5,13,27,40,32.5,67.5,tract_part,http://www.prisonersofthecensus.org/data/2010blocks/320019503025018/
3.20E+14,0,0,0,0,0,0,1,1,13,14,7.142857143,92.85714286,tract_part,http://www.prisonersofthecensus.org/data/2010blocks/320030076004006/
3.20E+14,0,0,0,0,0,1,3,4,0,4,100,0,tract_part,http://www.prisonersofthecensus.org/data/2010blocks/320030056133004/
3.20E+14,22,2,4,0,4,2,13,47,110,157,29.93630573,70.06369427,tract_part,http://www.prisonersofthecensus.org/data/2010blocks/320030057031022/
3.20E+14,1935,65,138,2,312,95,1199,3746,1717,5463,68.57038257,31.42961743,tract_part,http://www.prisonersofthecensus.org/data/2010blocks/320030075001000/
3.20E+14,31,0,0,0,0,2,59,92,110,202,45.54455446,54.45544554,tract,http://www.prisonersofthecensus.org/data/2010blocks/320030052002012/
3.20E+14,366,14,17,11,42,21,196,667,311,978,68.200409,31.799591,tract,http://www.prisonersofthecensus.org/data/2010blocks/320030005164018/
3.20E+14,1224,51,84,22,448,159,979,2967,1224,4191,70.79455977,29.20544023,tract,http://www.prisonersofthecensus.org/data/2010blocks/320030007001006/
3.20E+14,31,0,2,0,4,0,27,64,67,131,48.85496183,51.14503817,tract,http://www.prisonersofthecensus.org/data/2010blocks/320030008001000/
3.20E+14,0,0,0,0,0,0,0,0,1,1,0,100,tract_part,http://www.prisonersofthecensus.org/data/2010blocks/320030078002015/
3.20E+14,257,5,19,0,32,16,272,601,202,803,74.84433375,25.15566625,tract,http://www.prisonersofthecensus.org/data/2010blocks/320030044021001/
3.20E+14,181,23,21,0,14,6,82,327,428,755,43.31125828,56.68874172,tract_part,http://www.prisonersofthecensus.org/data/2010blocks/320030060011026/
3.20E+14,44,6,2,5,16,4,27,104,90,194,53.60824742,46.39175258,tract_part,http://www.prisonersofthecensus.org/data/2010blocks/320030029621045/
3.20E+14,0,0,0,0,0,0,0,0,9,9,0,100,tract_part,http://www.prisonersofthecensus.org/data/2010blocks/320030050142005/
3.20E+14,3,5,1,0,1,1,12,23,59,82,28.04878049,71.95121951,tract,http://www.prisonersofthecensus.org/data/2010blocks/320050014002034/
3.20E+14,35,1,2,0,0,0,24,62,50,112,55.35714286,44.64285714,tract_part,http://www.prisonersofthecensus.org/data/2010blocks/320079516001173/
3.20E+14,6,19,0,1,10,1,19,56,59,115,48.69565217,51.30434783,tract_part,http://www.prisonersofthecensus.org/data/2010blocks/320079510002054/
3.20E+14,0,14,0,0,0,0,0,14,0,14,100,0,tract_part,http://www.prisonersofthecensus.org/data/2010blocks/320079517001182/
3.20E+14,35,1,3,0,0,0,9,48,47,95,50.52631579,49.47368421,tract_part,http://www.prisonersofthecensus.org/data/2010blocks/320079502001045/
3.20E+14,0,0,0,0,0,0,0,0,1,1,0,100,tract_part,http://www.prisonersofthecensus.org/data/2010blocks/320099501002425/
3.20E+14,0,0,0,0,0,0,0,0,1,1,0,100,tract_part,http://www.prisonersofthecensus.org/data/2010blocks/320110001002391/
3.20E+14,0,1,0,0,9,2,11,23,11,34,67.64705882,32.35294118,tract_part,http://www.prisonersofthecensus.org/data/2010blocks/320130107013005/
3.20E+14,30,4,1,0,0,0,22,57,61,118,48.30508475,51.69491525,tract_part,http://www.prisonersofthecensus.org/data/2010blocks/320130105003565/
3.20E+14,30,1,2,0,1,0,12,46,29,75,61.33333333,38.66666667,institutionalized,http://www.prisonersofthecensus.org/data/2010blocks/320179501001533/
3.20E+14,44,3,3,1,6,1,30,88,71,159,55.34591195,44.65408805,institutionalized,http://www.prisonersofthecensus.org/data/2010blocks/320179501001534/
3.20E+14,2,6,0,0,0,0,13,21,48,69,30.43478261,69.56521739,tract_part,http://www.prisonersofthecensus.org/data/2010blocks/320199609003064/
3.20E+14,3,0,0,0,0,0,1,4,14,18,22.22222222,77.77777778,tract_part,http://www.prisonersofthecensus.org/data/2010blocks/320219707002189/
3.20E+14,9,1,1,0,0,0,0,11,9,20,55,45,tract_part,http://www.prisonersofthecensus.org/data/2010blocks/320239604012585/
3.20E+14,28,0,0,0,0,0,2,30,37,67,44.7761194,55.2238806,institutionalized,http://www.prisonersofthecensus.org/data/2010blocks/320239602001835/
3.20E+14,25,0,0,0,7,0,8,40,32,72,55.55555556,44.44444444,institutionalized,http://www.prisonersofthecensus.org/data/2010blocks/320239602002096/
3.20E+14,0,0,0,0,1,3,1,5,5,10,50,50,tract_part,http://www.prisonersofthecensus.org/data/2010blocks/320279601005027/
3.20E+14,235,20,28,0,0,1,453,737,917,1654,44.55864571,55.44135429,tract_part,http://www.prisonersofthecensus.org/data/2010blocks/320279601002149/
3.20E+14,1,0,0,0,0,0,0,1,4,5,20,80,tract_part,http://www.prisonersofthecensus.org/data/2010blocks/320299702003287/
3.20E+14,125,49,3,0,4,10,276,467,639,1106,42.22423146,57.77576854,tract_part,http://www.prisonersofthecensus.org/data/2010blocks/320310026172010/
3.20E+14,2,0,0,0,1,0,1,4,20,24,16.66666667,83.33333333,tract,http://www.prisonersofthecensus.org/data/2010blocks/320310015021010/
3.20E+14,7,9,0,0,0,0,7,23,45,68,33.82352941,66.17647059,tract_part,http://www.prisonersofthecensus.org/data/2010blocks/320310021071000/
3.20E+14,1,0,0,0,1,0,1,3,13,16,18.75,81.25,tract_part,http://www.prisonersofthecensus.org/data/2010blocks/320339702001173/
3.20E+14,345,26,21,0,2,0,273,667,463,1130,59.02654867,40.97345133,tract_part,http://www.prisonersofthecensus.org/data/2010blocks/320339702004050/
3.25E+14,5,10,1,0,0,2,1,19,126,145,13.10344828,86.89655172,institutionalized,http://www.prisonersofthecensus.org/data/2010blocks/325100006001012/
3.25E+14,307,40,27,0,3,1,285,663,635,1298,51.07858243,48.92141757,institutionalized,http://www.prisonersofthecensus.org/data/2010blocks/325100006003001/
3.25E+14,367,43,34,2,6,3,229,684,1129,1813,37.72752344,62.27247656,tract,http://www.prisonersofthecensus.org/data/2010blocks/325100008003024/
3.30E+14,1,0,2,0,0,0,2,5,90,95,5.263157895,94.73684211,tract,http://www.prisonersofthecensus.org/data/2010blocks/330019660004050/
3.30E+14,1,1,0,0,0,0,3,5,50,55,9.090909091,90.90909091,tract_part,http://www.prisonersofthecensus.org/data/2010blocks/330039559001105/
3.30E+14,5,2,0,0,0,0,3,10,134,144,6.944444444,93.05555556,tract_part,http://www.prisonersofthecensus.org/data/2010blocks/330059715001036/
3.30E+14,47,5,2,0,6,8,54,122,643,765,15.94771242,84.05228758,tract,http://www.prisonersofthecensus.org/data/2010blocks/330079506001010/
3.30E+14,0,0,0,0,0,0,0,0,29,29,0,100,tract_part,http://www.prisonersofthecensus.org/data/2010blocks/330079501003093/
3.30E+14,0,0,0,0,0,0,0,0,4,4,0,100,tract_part,http://www.prisonersofthecensus.org/data/2010blocks/330079511002019/
3.30E+14,7,0,3,0,0,3,2,15,103,118,12.71186441,87.28813559,tract_part,http://www.prisonersofthecensus.org/data/2010blocks/330099606003044/
3.30E+14,9,0,0,0,4,2,2,17,109,126,13.49206349,86.50793651,tract_part,http://www.prisonersofthecensus.org/data/2010blocks/330110028005002/
3.30E+14,3,0,0,0,0,4,4,11,53,64,17.1875,82.8125,tract,http://www.prisonersofthecensus.org/data/2010blocks/330110014001005/
3.30E+14,45,11,0,0,33,24,89,202,440,642,31.46417445,68.53582555,tract,http://www.prisonersofthecensus.org/data/2010blocks/330110019002001/
3.30E+14,4,0,0,0,0,0,0,4,8,12,33.33333333,66.66666667,tract,http://www.prisonersofthecensus.org/data/2010blocks/330112004001024/
3.30E+14,15,0,0,0,0,0,4,19,231,250,7.6,92.4,tract,http://www.prisonersofthecensus.org/data/2010blocks/330130380001004/
3.30E+14,1,0,0,0,0,0,1,2,42,44,4.545454545,95.45454545,tract,http://www.prisonersofthecensus.org/data/2010blocks/330130321001027/
3.30E+14,129,9,10,0,24,1,105,278,1511,1789,15.53940749,84.46059251,tract,http://www.prisonersofthecensus.org/data/2010blocks/330130326002008/
3.30E+14,19,2,2,0,14,11,36,84,230,314,26.75159236,73.24840764,tract,http://www.prisonersofthecensus.org/data/2010blocks/330150600001005/
3.30E+14,46,6,5,2,15,15,44,133,308,441,30.15873016,69.84126984,tract,http://www.prisonersofthecensus.org/data/2010blocks/330170816002009/
3.30E+14,0,0,0,0,0,0,0,0,1,1,0,100,tract,http://www.prisonersofthecensus.org/data/2010blocks/330170830012013/
3.30E+14,4,0,0,0,0,0,0,4,78,82,4.87804878,95.12195122,institutionalized,http://www.prisonersofthecensus.org/data/2010blocks/330199756001023/
3.30E+14,1,0,0,0,0,0,1,2,15,17,11.76470588,88.23529412,remaining,http://www.prisonersofthecensus.org/data/2010blocks/330199756001025/
3.40E+14,544,1,15,0,40,5,146,751,274,1025,73.26829268,26.73170732,tract_part,http://www.prisonersofthecensus.org/data/2010blocks/340010114043046/
3.40E+14,8,0,0,0,0,0,8,16,29,45,35.55555556,64.44444444,institutionalized,http://www.prisonersofthecensus.org/data/2010blocks/340030236023001/
3.40E+14,272,0,19,0,4,2,247,544,184,728,74.72527473,25.27472527,institutionalized,http://www.prisonersofthecensus.org/data/2010blocks/340030236023005/
3.40E+14,171,0,1,0,4,3,29,208,141,349,59.59885387,40.40114613,tract,http://www.prisonersofthecensus.org/data/2010blocks/340057046002029/
3.40E+14,319,4,7,1,77,28,158,594,166,760,78.15789474,21.84210526,tract_part,http://www.prisonersofthecensus.org/data/2010blocks/340057048013032/
3.40E+14,1910,35,85,0,339,125,1186,3680,1578,5258,69.98858882,30.01141118,tract_part,http://www.prisonersofthecensus.org/data/2010blocks/340057048024043/
3.40E+14,93,0,0,0,2,0,16,111,79,190,58.42105263,41.57894737,tract,http://www.prisonersofthecensus.org/data/2010blocks/340057022041010/
3.40E+14,54,0,1,0,10,0,12,77,7,84,91.66666667,8.333333333,tract,http://www.prisonersofthecensus.org/data/2010blocks/340076103001042/
3.40E+14,913,7,9,2,179,43,342,1495,464,1959,76.31444615,23.68555385,tract,http://www.prisonersofthecensus.org/data/2010blocks/340076104002008/
3.40E+14,79,0,0,1,39,0,48,167,123,290,57.5862069,42.4137931,tract,http://www.prisonersofthecensus.org/data/2010blocks/340090210011043/
3.40E+14,274,0,0,0,42,6,126,448,145,593,75.54806071,24.45193929,tract,http://www.prisonersofthecensus.org/data/2010blocks/340110202001008/
3.40E+14,2277,11,22,0,165,13,646,3134,851,3985,78.64491844,21.35508156,tract,http://www.prisonersofthecensus.org/data/2010blocks/340110205032043/
3.40E+14,772,15,14,0,121,51,302,1275,172,1447,88.11333794,11.88666206,tract,http://www.prisonersofthecensus.org/data/2010blocks/340110104021000/
3.40E+14,1480,4,6,0,80,13,373,1956,457,2413,81.06092002,18.93907998,institutionalized,http://www.prisonersofthecensus.org/data/2010blocks/340110101031000/
3.40E+14,1317,26,12,2,157,62,427,2003,419,2422,82.70024773,17.29975227,institutionalized,http://www.prisonersofthecensus.org/data/2010blocks/340110101031005/
3.40E+14,21,0,0,0,0,0,6,27,87,114,23.68421053,76.31578947,institutionalized,http://www.prisonersofthecensus.org/data/2010blocks/340110407003017/
3.40E+14,11,0,1,0,1,0,5,18,43,61,29.50819672,70.49180328,institutionalized,http://www.prisonersofthecensus.org/data/2010blocks/340110407003021/
3.40E+14,22,0,0,0,0,1,4,27,83,110,24.54545455,75.45454545,tract,http://www.prisonersofthecensus.org/data/2010blocks/340110409012004/
3.40E+14,0,0,0,0,0,0,1,1,3,4,25,75,tract,http://www.prisonersofthecensus.org/data/2010blocks/340130155004001/
3.40E+14,82,0,0,0,8,0,28,118,7,125,94.4,5.6,tract,http://www.prisonersofthecensus.org/data/2010blocks/340130067001002/
3.40E+14,1776,4,17,0,99,8,442,2346,234,2580,90.93023256,9.069767442,tract,http://www.prisonersofthecensus.org/data/2010blocks/340130074001003/
3.40E+14,27,0,0,0,7,0,7,41,13,54,75.92592593,24.07407407,tract,http://www.prisonersofthecensus.org/data/2010blocks/340130081002022/
3.40E+14,10,0,0,0,0,0,7,17,4,21,80.95238095,19.04761905,tract,http://www.prisonersofthecensus.org/data/2010blocks/340130087003001/
3.40E+14,72,0,1,0,0,0,11,84,4,88,95.45454545,4.545454545,tract,http://www.prisonersofthecensus.org/data/2010blocks/340130092001004/
3.40E+14,2511,5,12,0,241,14,677,3460,445,3905,88.60435339,11.39564661,tract,http://www.prisonersofthecensus.org/data/2010blocks/340139801001016/
3.40E+14,108,0,0,0,4,1,17,130,14,144,90.27777778,9.722222222,institutionalized,http://www.prisonersofthecensus.org/data/2010blocks/340139802001067/
3.40E+14,329,0,2,0,50,4,83,468,87,555,84.32432432,15.67567568,institutionalized,http://www.prisonersofthecensus.org/data/2010blocks/340139802001068/
3.40E+14,359,3,0,0,39,2,68,471,70,541,87.06099815,12.93900185,institutionalized,http://www.prisonersofthecensus.org/data/2010blocks/340139802001126/
3.40E+14,14,1,0,0,0,0,2,17,27,44,38.63636364,61.36363636,tract_part,http://www.prisonersofthecensus.org/data/2010blocks/340155006003006/
3.40E+14,168,0,3,0,11,5,23,210,166,376,55.85106383,44.14893617,tract,http://www.prisonersofthecensus.org/data/2010blocks/340155010021003/
3.40E+14,6,0,0,0,0,0,13,19,6,25,76,24,tract_part,http://www.prisonersofthecensus.org/data/2010blocks/340155022002103/
3.40E+14,964,3,8,17,91,35,797,1915,195,2110,90.75829384,9.241706161,tract,http://www.prisonersofthecensus.org/data/2010blocks/340170127005027/
3.40E+14,23,0,2,0,1,1,13,40,79,119,33.61344538,66.38655462,tract,http://www.prisonersofthecensus.org/data/2010blocks/340190114003013/
3.40E+14,472,5,10,3,66,33,184,773,739,1512,51.12433862,48.87566138,tract,http://www.prisonersofthecensus.org/data/2010blocks/340190107011049/
3.40E+14,461,1,8,2,29,15,112,628,417,1045,60.09569378,39.90430622,tract,http://www.prisonersofthecensus.org/data/2010blocks/340190118002022/
3.40E+14,119,2,2,0,22,5,34,184,73,257,71.59533074,28.40466926,tract,http://www.prisonersofthecensus.org/data/2010blocks/340210037053015/
3.40E+14,20,0,0,0,0,0,6,26,10,36,72.22222222,27.77777778,tract,http://www.prisonersofthecensus.org/data/2010blocks/340210009003023/
3.40E+14,299,12,4,1,51,27,131,525,93,618,84.95145631,15.04854369,tract,http://www.prisonersofthecensus.org/data/2010blocks/340210013002001/
3.40E+14,366,0,7,0,3,0,101,477,114,591,80.7106599,19.2893401,tract,http://www.prisonersofthecensus.org/data/2010blocks/340210018001001/
3.40E+14,1249,32,17,0,114,97,353,1862,296,2158,86.28359592,13.71640408,tract,http://www.prisonersofthecensus.org/data/2010blocks/340210024001000/
3.40E+14,0,0,1,0,0,0,0,1,4,5,20,80,tract,http://www.prisonersofthecensus.org/data/2010blocks/340230051001000/
3.40E+14,7,0,0,0,2,0,2,11,5,16,68.75,31.25,tract,http://www.prisonersofthecensus.org/data/2010blocks/340230093004004/
3.40E+14,428,6,1,6,107,14,305,867,262,1129,76.79362267,23.20637733,tract,http://www.prisonersofthecensus.org/data/2010blocks/340230062031027/
3.40E+14,1343,27,11,2,201,94,548,2226,725,2951,75.43205693,24.56794307,institutionalized,http://www.prisonersofthecensus.org/data/2010blocks/340230090001010/
3.40E+14,75,3,6,0,18,10,60,172,240,412,41.74757282,58.25242718,institutionalized,http://www.prisonersofthecensus.org/data/2010blocks/340230090001023/
3.40E+14,533,1,20,6,1,3,303,867,441,1308,66.28440367,33.71559633,tract,http://www.prisonersofthecensus.org/data/2010blocks/340258104013058/
3.40E+14,121,0,0,0,7,2,76,206,214,420,49.04761905,50.95238095,tract,http://www.prisonersofthecensus.org/data/2010blocks/340270433012017/
3.40E+14,0,0,0,0,0,0,0,0,14,14,0,100,tract_part,http://www.prisonersofthecensus.org/data/2010blocks/340297155001025/
3.40E+14,131,1,1,0,22,4,97,256,309,565,45.30973451,54.69026549,tract,http://www.prisonersofthecensus.org/data/2010blocks/340297231001028/
3.40E+14,30,0,2,0,0,2,8,42,9,51,82.35294118,17.64705882,tract,http://www.prisonersofthecensus.org/data/2010blocks/340311817021000/
3.40E+14,506,0,3,0,0,0,410,919,134,1053,87.27445394,12.72554606,tract,http://www.prisonersofthecensus.org/data/2010blocks/340311818003001/
3.40E+14,162,0,1,0,25,0,34,222,91,313,70.92651757,29.07348243,tract_part,http://www.prisonersofthecensus.org/data/2010blocks/340330213001036/
3.40E+14,127,0,2,0,7,3,60,199,88,287,69.33797909,30.66202091,tract,http://www.prisonersofthecensus.org/data/2010blocks/340350501001004/
3.40E+14,36,0,3,1,4,2,33,79,102,181,43.64640884,56.35359116,tract,http://www.prisonersofthecensus.org/data/2010blocks/340373737002000/
3.40E+14,1,0,0,0,0,0,0,1,0,1,100,0,tract,http://www.prisonersofthecensus.org/data/2010blocks/340390314003000/
3.40E+14,64,0,9,2,10,3,111,199,55,254,78.34645669,21.65354331,tract,http://www.prisonersofthecensus.org/data/2010blocks/340390398004083/
3.40E+14,431,2,25,2,23,15,222,720,199,919,78.34602829,21.65397171,tract,http://www.prisonersofthecensus.org/data/2010blocks/340390399002021/
3.40E+14,32,0,0,0,3,0,10,45,94,139,32.37410072,67.62589928,tract_part,http://www.prisonersofthecensus.org/data/2010blocks/340410316013039/
3.50E+14,12,123,1,0,32,14,437,619,30,649,95.37750385,4.622496148,tract,http://www.prisonersofthecensus.org/data/2010blocks/350010021001013/
3.50E+14,7,20,0,0,9,2,25,63,10,73,86.30136986,13.69863014,tract,http://www.prisonersofthecensus.org/data/2010blocks/350010029002025/
3.50E+14,1,0,0,0,4,0,5,10,4,14,71.42857143,28.57142857,tract,http://www.prisonersofthecensus.org/data/2010blocks/350010032021028/
3.50E+14,3,20,0,0,0,1,22,46,9,55,83.63636364,16.36363636,tract_part,http://www.prisonersofthecensus.org/data/2010blocks/350010034002039/
3.50E+14,6,15,0,1,2,0,88,112,32,144,77.77777778,22.22222222,tract_part,http://www.prisonersofthecensus.org/data/2010blocks/350010034003028/
3.50E+14,0,0,0,0,0,0,0,0,4,4,0,100,tract_part,http://www.prisonersofthecensus.org/data/2010blocks/350010008012158/
3.50E+14,279,392,3,2,677,53,1182,2588,838,3426,75.53998832,24.46001168,tract_part,http://www.prisonersofthecensus.org/data/2010blocks/350019406001133/
3.50E+14,0,0,0,0,0,0,0,0,3,3,0,100,tract_part,http://www.prisonersofthecensus.org/data/2010blocks/350039764003110/
3.50E+14,22,46,2,0,53,5,134,262,84,346,75.72254335,24.27745665,tract_part,http://www.prisonersofthecensus.org/data/2010blocks/350050013002298/
3.50E+14,11,8,0,0,56,3,129,207,62,269,76.95167286,23.04832714,tract_part,http://www.prisonersofthecensus.org/data/2010blocks/350050006001073/
3.50E+14,49,58,1,1,0,0,320,429,162,591,72.58883249,27.41116751,tract_part,http://www.prisonersofthecensus.org/data/2010blocks/350069742013007/
3.50E+14,1,32,6,0,0,6,1144,1189,72,1261,94.29024584,5.709754163,tract_part,http://www.prisonersofthecensus.org/data/2010blocks/350069747003431/
3.50E+14,28,39,1,1,9,1,236,315,109,424,74.29245283,25.70754717,tract_part,http://www.prisonersofthecensus.org/data/2010blocks/350069747002247/
3.50E+14,0,34,0,0,0,3,0,37,0,37,100,0,tract_part,http://www.prisonersofthecensus.org/data/2010blocks/350069461001118/
3.50E+14,0,0,0,0,0,0,4,4,45,49,8.163265306,91.83673469,tract_part,http://www.prisonersofthecensus.org/data/2010blocks/350079505006138/
3.50E+14,22,41,0,0,0,2,128,193,35,228,84.64912281,15.35087719,tract_part,http://www.prisonersofthecensus.org/data/2010blocks/350079507001941/
3.50E+14,35,2,0,0,32,1,134,204,106,310,65.80645161,34.19354839,tract,http://www.prisonersofthecensus.org/data/2010blocks/350090001005000/
3.50E+14,0,0,0,0,0,0,6,6,3,9,66.66666667,33.33333333,tract_part,http://www.prisonersofthecensus.org/data/2010blocks/350119601001147/
3.50E+14,39,50,0,0,81,15,367,552,242,794,69.52141058,30.47858942,tract_part,http://www.prisonersofthecensus.org/data/2010blocks/350130015003277/
3.50E+14,35,20,3,0,144,18,478,698,280,978,71.37014315,28.62985685,tract_part,http://www.prisonersofthecensus.org/data/2010blocks/350130002011016/
3.50E+14,0,1,0,0,0,0,1,2,0,2,100,0,tract_part,http://www.prisonersofthecensus.org/data/2010blocks/350150010003004/
3.50E+14,6,0,0,0,4,0,127,137,73,210,65.23809524,34.76190476,tract,http://www.prisonersofthecensus.org/data/2010blocks/350150001001092/
3.50E+14,2,0,0,0,0,2,55,59,16,75,78.66666667,21.33333333,tract_part,http://www.prisonersofthecensus.org/data/2010blocks/350179644003006/
3.50E+14,60,27,2,0,2,15,324,430,144,574,74.91289199,25.08710801,tract_part,http://www.prisonersofthecensus.org/data/2010blocks/350199616001374/
3.50E+14,2,0,0,0,2,3,15,22,7,29,75.86206897,24.13793103,tract_part,http://www.prisonersofthecensus.org/data/2010blocks/350239702002090/
3.50E+14,2,0,0,0,0,0,9,11,2,13,84.61538462,15.38461538,tract,http://www.prisonersofthecensus.org/data/2010blocks/350250001003006/
3.50E+14,86,101,5,0,219,51,664,1126,303,1429,78.79636109,21.20363891,tract_part,http://www.prisonersofthecensus.org/data/2010blocks/350250007022147/
3.50E+14,24,0,0,0,3,1,103,131,141,272,48.16176471,51.83823529,tract_part,http://www.prisonersofthecensus.org/data/2010blocks/350250010031068/
3.50E+14,1,18,0,0,2,2,6,29,72,101,28.71287129,71.28712871,tract_part,http://www.prisonersofthecensus.org/data/2010blocks/350279602002043/
3.50E+14,1,0,0,0,0,0,5,6,4,10,60,40,tract_part,http://www.prisonersofthecensus.org/data/2010blocks/350280004002032/
3.50E+14,7,1,2,1,48,6,198,263,259,522,50.38314176,49.61685824,tract_part,http://www.prisonersofthecensus.org/data/2010blocks/350290006001030/
3.50E+14,0,18,0,0,0,0,1,19,0,19,100,0,tract_part,http://www.prisonersofthecensus.org/data/2010blocks/350319403002021/
3.50E+14,0,9,0,0,0,0,0,9,0,9,100,0,tract_part,http://www.prisonersofthecensus.org/data/2010blocks/350319405001324/
3.50E+14,18,8,1,0,8,3,69,107,118,225,47.55555556,52.44444444,tract_part,http://www.prisonersofthecensus.org/data/2010blocks/350350006021068/
3.50E+14,0,0,0,0,0,0,1,1,1,2,50,50,tract_part,http://www.prisonersofthecensus.org/data/2010blocks/350350006011128/
3.50E+14,23,39,10,0,17,1,164,254,840,1094,23.21755027,76.78244973,tract_part,http://www.prisonersofthecensus.org/data/2010blocks/350350009023549/
3.50E+14,1,1,0,0,0,0,5,7,11,18,38.88888889,61.11111111,tract_part,http://www.prisonersofthecensus.org/data/2010blocks/350379586022050/
3.50E+14,0,50,0,0,0,0,6,56,0,56,100,0,tract_part,http://www.prisonersofthecensus.org/data/2010blocks/350399410001004/
3.50E+14,2,0,0,0,0,0,98,100,1,101,99.00990099,0.99009901,tract_part,http://www.prisonersofthecensus.org/data/2010blocks/350390005003687/
3.50E+14,6,4,0,0,24,3,52,89,33,122,72.95081967,27.04918033,tract_part,http://www.prisonersofthecensus.org/data/2010blocks/350410002002043/
3.50E+14,7,67,0,1,108,0,180,363,72,435,83.44827586,16.55172414,tract_part,http://www.prisonersofthecensus.org/data/2010blocks/350430107023027/
3.50E+14,11,377,0,0,64,19,116,587,131,718,81.75487465,18.24512535,tract_part,http://www.prisonersofthecensus.org/data/2010blocks/350450006072017/
3.50E+14,1,28,0,0,1,0,9,39,9,48,81.25,18.75,tract_part,http://www.prisonersofthecensus.org/data/2010blocks/350450004012027/
3.50E+14,0,35,0,0,0,1,0,36,0,36,100,0,tract_part,http://www.prisonersofthecensus.org/data/2010blocks/350459428021065/
3.50E+14,4,2,0,0,16,3,87,112,11,123,91.05691057,8.943089431,tract_part,http://www.prisonersofthecensus.org/data/2010blocks/350479574004079/
3.50E+14,0,1,0,0,0,0,8,9,4,13,69.23076923,30.76923077,tract_part,http://www.prisonersofthecensus.org/data/2010blocks/350479577001183/
3.50E+14,0,0,1,0,0,3,2,6,9,15,40,60,tract_part,http://www.prisonersofthecensus.org/data/2010blocks/350490104001015/
3.50E+14,7,36,0,0,6,1,224,274,137,411,66.66666667,33.33333333,tract_part,http://www.prisonersofthecensus.org/data/2010blocks/350490106011117/
3.51E+14,45,25,4,1,1,0,381,457,112,569,80.31634446,19.68365554,institutionalized,http://www.prisonersofthecensus.org/data/2010blocks/350499800001000/
3.51E+14,18,16,0,0,0,0,204,238,40,278,85.61151079,14.38848921,institutionalized,http://www.prisonersofthecensus.org/data/2010blocks/350499800001006/
3.51E+14,1,0,0,0,4,2,20,27,30,57,47.36842105,52.63157895,tract,http://www.prisonersofthecensus.org/data/2010blocks/350519622001113/
3.51E+14,0,3,0,0,1,0,17,21,1,22,95.45454545,4.545454545,tract_part,http://www.prisonersofthecensus.org/data/2010blocks/350539783023054/
3.51E+14,0,0,0,0,0,0,0,0,2,2,0,100,tract_part,http://www.prisonersofthecensus.org/data/2010blocks/350559527002168/
3.51E+14,0,0,1,0,4,0,16,21,6,27,77.77777778,22.22222222,tract_part,http://www.prisonersofthecensus.org/data/2010blocks/350559526003000/
3.51E+14,53,67,3,0,14,16,180,333,298,631,52.77337559,47.22662441,tract_part,http://www.prisonersofthecensus.org/data/2010blocks/350579636003002/
3.51E+14,61,34,9,0,45,14,397,560,136,696,80.45977011,19.54022989,tract_part,http://www.prisonersofthecensus.org/data/2010blocks/350599502003558/
3.51E+14,2,15,1,0,53,2,100,173,29,202,85.64356436,14.35643564,tract_part,http://www.prisonersofthecensus.org/data/2010blocks/350619704012010/
3.51E+14,61,58,1,0,0,0,361,481,135,616,78.08441558,21.91558442,institutionalized,http://www.prisonersofthecensus.org/data/2010blocks/350619707004006/
3.51E+14,48,79,0,0,1,0,301,429,177,606,70.79207921,29.20792079,institutionalized,http://www.prisonersofthecensus.org/data/2010blocks/350619707004010/
3.60E+14,384,1,5,0,6,2,64,462,231,693,66.66666667,33.33333333,tract,http://www.prisonersofthecensus.org/data/2010blocks/360010137031094/
3.60E+14,28,1,4,0,10,4,18,65,49,114,57.01754386,42.98245614,tract_part,http://www.prisonersofthecensus.org/data/2010blocks/360039506003063/
3.60E+14,5276,73,93,14,1932,4,2801,10193,550,10743,94.88038723,5.119612771,institutionalized,http://www.prisonersofthecensus.org/data/2010blocks/360050001001000/
3.60E+14,1239,44,87,14,589,2,978,2953,232,3185,92.71585557,7.284144427,institutionalized,http://www.prisonersofthecensus.org/data/2010blocks/360050001001013/
3.60E+14,3,0,0,0,2,0,3,8,0,8,100,0,tract,http://www.prisonersofthecensus.org/data/2010blocks/360050041002002/
3.60E+14,420,4,56,0,134,1,346,961,62,1023,93.93939394,6.060606061,tract,http://www.prisonersofthecensus.org/data/2010blocks/360050093006036/
3.60E+14,75,1,1,0,6,1,62,146,7,153,95.4248366,4.575163399,tract,http://www.prisonersofthecensus.org/data/2010blocks/360050169001004/
3.60E+14,2,0,0,0,1,0,4,7,0,7,100,0,tract,http://www.prisonersofthecensus.org/data/2010blocks/360050210014000/
3.60E+14,3,0,1,0,0,0,0,4,7,11,36.36363636,63.63636364,tract,http://www.prisonersofthecensus.org/data/2010blocks/360070002002008/
3.60E+14,1,0,0,0,0,0,0,1,9,10,10,90,tract,http://www.prisonersofthecensus.org/data/2010blocks/360070011001001/
3.60E+14,180,0,2,0,18,4,39,243,256,499,48.69739479,51.30260521,tract_part,http://www.prisonersofthecensus.org/data/2010blocks/360070128004014/
3.60E+14,21,12,0,0,0,0,3,36,75,111,32.43243243,67.56756757,tract_part,http://www.prisonersofthecensus.org/data/2010blocks/360099606003033/
3.60E+14,1058,14,6,0,145,6,285,1514,395,1909,79.3085385,20.6914615,tract,http://www.prisonersofthecensus.org/data/2010blocks/360110421003007/
3.60E+14,563,11,3,0,69,2,130,778,335,1113,69.90116801,30.09883199,tract_part,http://www.prisonersofthecensus.org/data/2010blocks/360110408003027/
3.60E+14,39,4,0,0,4,1,21,69,99,168,41.07142857,58.92857143,tract,http://www.prisonersofthecensus.org/data/2010blocks/360110406001020/
3.60E+14,82,1,1,0,1,0,26,111,150,261,42.52873563,57.47126437,tract_part,http://www.prisonersofthecensus.org/data/2010blocks/360130364013021/
3.60E+14,348,4,8,0,69,1,144,574,294,868,66.12903226,33.87096774,tract_part,http://www.prisonersofthecensus.org/data/2010blocks/360130363001044/
3.60E+14,1040,17,6,0,101,1,264,1429,507,1936,73.81198347,26.18801653,tract,http://www.prisonersofthecensus.org/data/2010blocks/360150003001000/
3.60E+14,88,4,1,0,1,4,10,108,102,210,51.42857143,48.57142857,tract,http://www.prisonersofthecensus.org/data/2010blocks/360150007004016/
3.60E+14,609,0,7,0,70,1,163,850,137,987,86.1195542,13.8804458,tract_part,http://www.prisonersofthecensus.org/data/2010blocks/360150112006000/
3.60E+14,18,0,0,0,0,0,4,22,66,88,25,75,tract_part,http://www.prisonersofthecensus.org/data/2010blocks/360179706012004/
3.60E+14,238,0,3,0,14,1,68,324,118,442,73.30316742,26.69683258,tract_part,http://www.prisonersofthecensus.org/data/2010blocks/360191003006037/
3.60E+14,430,4,2,0,46,1,146,629,202,831,75.69193742,24.30806258,institutionalized,http://www.prisonersofthecensus.org/data/2010blocks/360191004006001/
3.60E+14,1214,20,14,0,111,4,358,1721,529,2250,76.48888889,23.51111111,institutionalized,http://www.prisonersofthecensus.org/data/2010blocks/360191004006011/
3.60E+14,71,0,0,0,7,0,19,97,23,120,80.83333333,19.16666667,tract_part,http://www.prisonersofthecensus.org/data/2010blocks/360191004002000/
3.60E+14,0,0,0,0,0,0,0,0,2,2,0,100,tract,http://www.prisonersofthecensus.org/data/2010blocks/360191013004007/
3.60E+14,29,10,3,0,17,8,28,95,159,254,37.4015748,62.5984252,tract_part,http://www.prisonersofthecensus.org/data/2010blocks/360191008003013/
3.60E+14,30,1,0,0,3,3,11,48,64,112,42.85714286,57.14285714,tract_part,http://www.prisonersofthecensus.org/data/2010blocks/360210011001035/
3.60E+14,65,3,0,0,0,0,17,85,25,110,77.27272727,22.72727273,institutionalized,http://www.prisonersofthecensus.org/data/2010blocks/360210013002003/
3.60E+14,35,0,0,0,7,0,9,51,31,82,62.19512195,37.80487805,institutionalized,http://www.prisonersofthecensus.org/data/2010blocks/360210013002007/
3.60E+14,51,1,1,0,5,0,18,76,56,132,57.57575758,42.42424242,institutionalized,http://www.prisonersofthecensus.org/data/2010blocks/360210013002008/
3.60E+14,37,1,0,0,2,0,5,45,8,53,84.90566038,15.09433962,institutionalized,http://www.prisonersofthecensus.org/data/2010blocks/360210013002009/
3.60E+14,5,0,1,0,0,0,3,9,54,63,14.28571429,85.71428571,tract,http://www.prisonersofthecensus.org/data/2010blocks/360239706002004/
3.60E+14,0,0,0,0,0,0,0,0,4,4,0,100,tract_part,http://www.prisonersofthecensus.org/data/2010blocks/360239704001009/
3.60E+14,0,0,0,0,0,0,0,0,3,3,0,100,tract_part,http://www.prisonersofthecensus.org/data/2010blocks/360259713002050/
3.60E+14,6,1,0,1,3,1,7,19,65,84,22.61904762,77.38095238,tract_part,http://www.prisonersofthecensus.org/data/2010blocks/360259708003025/
3.60E+14,77,1,0,0,3,0,18,99,77,176,56.25,43.75,tract,http://www.prisonersofthecensus.org/data/2010blocks/360272101013001/
3.60E+14,413,1,6,0,106,1,219,746,185,931,80.12889366,19.87110634,institutionalized,http://www.prisonersofthecensus.org/data/2010blocks/360276400021008/
3.60E+14,577,1,3,0,103,2,220,906,182,1088,83.27205882,16.72794118,institutionalized,http://www.prisonersofthecensus.org/data/2010blocks/360276400021009/
3.60E+14,1286,8,29,0,220,13,500,2056,309,2365,86.93446089,13.06553911,tract,http://www.prisonersofthecensus.org/data/2010blocks/360276100001001/
3.60E+14,730,3,1,0,47,0,254,1035,279,1314,78.76712329,21.23287671,tract_part,http://www.prisonersofthecensus.org/data/2010blocks/360270602011020/
3.60E+14,156,0,2,0,10,3,39,210,163,373,56.3002681,43.6997319,tract,http://www.prisonersofthecensus.org/data/2010blocks/360272202013001/
3.60E+14,1,0,1,0,0,0,1,3,7,10,30,70,tract,http://www.prisonersofthecensus.org/data/2010blocks/360272211001023/
3.60E+14,2,0,5,0,1,4,11,23,203,226,10.17699115,89.82300885,tract_part,http://www.prisonersofthecensus.org/data/2010blocks/360271401014012/
3.60E+14,549,6,1,0,80,0,139,775,233,1008,76.88492063,23.11507937,institutionalized,http://www.prisonersofthecensus.org/data/2010blocks/360290149041003/
3.60E+14,56,2,0,0,0,0,14,72,52,124,58.06451613,41.93548387,institutionalized,http://www.prisonersofthecensus.org/data/2010blocks/360290149041008/
3.60E+14,471,7,3,0,34,11,71,597,283,880,67.84090909,32.15909091,institutionalized,http://www.prisonersofthecensus.org/data/2010blocks/360290149041009/
3.60E+14,488,3,2,2,6,21,102,624,289,913,68.34611172,31.65388828,tract,http://www.prisonersofthecensus.org/data/2010blocks/360290165001068/
3.60E+14,9,0,0,0,0,0,0,9,2,11,81.81818182,18.18181818,tract,http://www.prisonersofthecensus.org/data/2010blocks/360290166004014/
3.60E+14,22,1,0,0,0,1,6,30,15,45,66.66666667,33.33333333,tract,http://www.prisonersofthecensus.org/data/2010blocks/360290168004018/
3.60E+14,0,0,0,0,1,0,0,1,2,3,33.33333333,66.66666667,tract,http://www.prisonersofthecensus.org/data/2010blocks/360290169004000/
3.60E+14,655,29,6,0,103,0,234,1027,737,1764,58.21995465,41.78004535,institutionalized,http://www.prisonersofthecensus.org/data/2010blocks/360290161001011/
3.60E+14,445,8,1,0,70,1,147,672,371,1043,64.4295302,35.5704698,institutionalized,http://www.prisonersofthecensus.org/data/2010blocks/360290161001016/
3.60E+14,30,0,0,0,0,3,3,36,33,69,52.17391304,47.82608696,tract_part,http://www.prisonersofthecensus.org/data/2010blocks/360319607001082/
3.60E+14,56,0,1,0,10,0,20,87,54,141,61.70212766,38.29787234,tract_part,http://www.prisonersofthecensus.org/data/2010blocks/360319610004019/
3.60E+14,183,6,4,1,63,17,144,418,43,461,90.67245119,9.327548807,institutionalized,http://www.prisonersofthecensus.org/data/2010blocks/360319605981006/
3.60E+14,395,24,14,2,150,37,353,975,107,1082,90.11090573,9.88909427,institutionalized,http://www.prisonersofthecensus.org/data/2010blocks/360319605981007/
3.60E+14,184,3,1,0,4,0,49,241,65,306,78.75816993,21.24183007,institutionalized,http://www.prisonersofthecensus.org/data/2010blocks/360319605985017/
3.60E+14,71,3,0,0,8,0,25,107,41,148,72.2972973,27.7027027,institutionalized,http://www.prisonersofthecensus.org/data/2010blocks/360319605985019/
3.60E+14,118,2,0,0,13,0,31,164,52,216,75.92592593,24.07407407,tract_part,http://www.prisonersofthecensus.org/data/2010blocks/360339501002001/
3.60E+14,1762,23,10,0,194,1,559,2549,596,3145,81.04928458,18.95071542,institutionalized,http://www.prisonersofthecensus.org/data/2010blocks/360339505022006/
3.60E+14,879,19,8,0,99,3,345,1353,478,1831,73.89404697,26.10595303,institutionalized,http://www.prisonersofthecensus.org/data/2010blocks/360339505022023/
3.60E+14,52,0,1,0,0,0,1,54,148,202,26.73267327,73.26732673,tract_part,http://www.prisonersofthecensus.org/data/2010blocks/360339511002007/
3.60E+14,6,0,0,0,3,0,10,19,52,71,26.76056338,73.23943662,tract,http://www.prisonersofthecensus.org/data/2010blocks/360359712001017/
3.60E+14,252,6,2,0,30,0,83,373,101,474,78.69198312,21.30801688,tract_part,http://www.prisonersofthecensus.org/data/2010blocks/360359706001000/
3.60E+14,13,1,0,0,0,0,0,14,55,69,20.28985507,79.71014493,tract,http://www.prisonersofthecensus.org/data/2010blocks/360379506002013/
3.60E+14,221,13,15,0,86,4,137,476,222,698,68.19484241,31.80515759,tract,http://www.prisonersofthecensus.org/data/2010blocks/360379504005008/
3.60E+14,10,0,0,0,0,0,6,16,39,55,29.09090909,70.90909091,tract_part,http://www.prisonersofthecensus.org/data/2010blocks/360390810003042/
3.60E+14,596,7,15,1,65,1,211,896,235,1131,79.2219275,20.7780725,institutionalized,http://www.prisonersofthecensus.org/data/2010blocks/360390808001007/
3.60E+14,1085,19,15,1,87,1,292,1500,377,1877,79.91475759,20.08524241,institutionalized,http://www.prisonersofthecensus.org/data/2010blocks/360390808001014/
3.60E+14,0,0,0,0,0,1,0,1,0,1,100,0,tract_part,http://www.prisonersofthecensus.org/data/2010blocks/360419505002192/
3.60E+14,1,0,0,1,0,0,1,3,24,27,11.11111111,88.88888889,tract_part,http://www.prisonersofthecensus.org/data/2010blocks/360430112005005/
3.60E+14,473,5,4,0,107,0,216,805,134,939,85.72949947,14.27050053,tract_part,http://www.prisonersofthecensus.org/data/2010blocks/360450602005069/
3.60E+14,39,2,0,0,0,0,5,46,105,151,30.46357616,69.53642384,tract,http://www.prisonersofthecensus.org/data/2010blocks/360450615003034/
3.60E+14,330,5,3,0,68,1,148,555,94,649,85.51617874,14.48382126,tract_part,http://www.prisonersofthecensus.org/data/2010blocks/360450624002051/
3.60E+14,771,4,33,3,18,56,1186,2071,269,2340,88.5042735,11.4957265,tract,http://www.prisonersofthecensus.org/data/2010blocks/360470018001013/
3.60E+14,5,0,0,0,2,0,3,10,0,10,100,0,tract,http://www.prisonersofthecensus.org/data/2010blocks/360470043001000/
3.60E+14,45,0,4,0,0,1,19,69,25,94,73.40425532,26.59574468,tract,http://www.prisonersofthecensus.org/data/2010blocks/360470283001001/
3.60E+14,23,0,1,0,5,0,16,45,14,59,76.27118644,23.72881356,tract,http://www.prisonersofthecensus.org/data/2010blocks/360470373004001/
3.60E+14,15,1,1,1,0,4,60,82,8,90,91.11111111,8.888888889,tract,http://www.prisonersofthecensus.org/data/2010blocks/360470908001001/
3.60E+14,NULL,NULL,NULL,NULL,NULL,NULL,NULL,#VALUE!,NULL,#VALUE!,#VALUE!,#VALUE!,,http://www.prisonersofthecensus.org/data/2010blocks/360471058011000/
3.60E+14,NULL,NULL,NULL,NULL,NULL,NULL,NULL,#VALUE!,NULL,#VALUE!,#VALUE!,#VALUE!,,http://www.prisonersofthecensus.org/data/2010blocks/360471058013000/
3.60E+14,3,0,0,0,1,0,1,5,0,5,100,0,tract,http://www.prisonersofthecensus.org/data/2010blocks/360471058044001/
3.61E+14,2,0,0,0,0,0,0,2,27,29,6.896551724,93.10344828,tract_part,http://www.prisonersofthecensus.org/data/2010blocks/360499505002143/
3.61E+14,16,0,1,0,2,3,6,28,64,92,30.43478261,69.56521739,tract_part,http://www.prisonersofthecensus.org/data/2010blocks/360510302013059/
3.61E+14,448,8,2,0,22,1,131,612,211,823,74.36208991,25.63791009,tract_part,http://www.prisonersofthecensus.org/data/2010blocks/360510308001133/
3.61E+14,432,10,3,1,64,1,141,652,417,1069,60.99158092,39.00841908,tract,http://www.prisonersofthecensus.org/data/2010blocks/360510310001023/
3.61E+14,91,1,0,0,3,0,32,127,34,161,78.88198758,21.11801242,tract_part,http://www.prisonersofthecensus.org/data/2010blocks/360530308003024/
3.61E+14,1,0,0,0,0,2,3,6,13,19,31.57894737,68.42105263,tract_part,http://www.prisonersofthecensus.org/data/2010blocks/360530310002149/
3.61E+14,7,3,0,0,1,0,2,13,90,103,12.62135922,87.37864078,tract,http://www.prisonersofthecensus.org/data/2010blocks/360539401031018/
3.61E+14,157,1,0,0,0,0,35,193,130,323,59.75232198,40.24767802,tract,http://www.prisonersofthecensus.org/data/2010blocks/360550130014029/
3.61E+14,1,0,0,0,0,1,0,2,1,3,66.66666667,33.33333333,tract,http://www.prisonersofthecensus.org/data/2010blocks/360550030001001/
3.61E+14,4,0,1,0,0,0,2,7,16,23,30.43478261,69.56521739,tract,http://www.prisonersofthecensus.org/data/2010blocks/360550036002008/
3.61E+14,0,0,0,0,0,0,1,1,0,1,100,0,tract,http://www.prisonersofthecensus.org/data/2010blocks/360550038054000/
3.61E+14,23,0,0,0,0,0,2,25,6,31,80.64516129,19.35483871,tract,http://www.prisonersofthecensus.org/data/2010blocks/360550093011004/
3.61E+14,666,0,5,0,0,1,122,794,295,1089,72.91092746,27.08907254,tract,http://www.prisonersofthecensus.org/data/2010blocks/360550094003029/
3.61E+14,28,0,2,0,0,0,4,34,27,61,55.73770492,44.26229508,tract,http://www.prisonersofthecensus.org/data/2010blocks/360550095002014/
3.61E+14,18,1,0,0,0,0,39,58,49,107,54.20560748,45.79439252,tract_part,http://www.prisonersofthecensus.org/data/2010blocks/360570727001036/
3.61E+14,816,0,9,0,271,9,380,1485,459,1944,76.38888889,23.61111111,tract,http://www.prisonersofthecensus.org/data/2010blocks/360594078021001/
3.61E+14,1,0,0,0,1,0,3,5,2,7,71.42857143,28.57142857,tract,http://www.prisonersofthecensus.org/data/2010blocks/360594139001009/
3.61E+14,424,1,7,0,197,0,209,838,45,883,94.90373726,5.096262741,institutionalized,http://www.prisonersofthecensus.org/data/2010blocks/360610029001002/
3.61E+14,290,2,24,4,4,8,350,682,212,894,76.28635347,23.71364653,institutionalized,http://www.prisonersofthecensus.org/data/2010blocks/360610029004007/
3.61E+14,103,0,1,0,6,0,34,144,38,182,79.12087912,20.87912088,tract,http://www.prisonersofthecensus.org/data/2010blocks/360610099001042/
3.61E+14,116,1,2,0,31,0,47,197,46,243,81.06995885,18.93004115,tract,http://www.prisonersofthecensus.org/data/2010blocks/360610186002001/
3.61E+14,98,0,1,0,4,1,22,126,5,131,96.18320611,3.816793893,tract,http://www.prisonersofthecensus.org/data/2010blocks/360610243011001/
3.61E+14,184,10,3,0,0,0,27,224,279,503,44.53280318,55.46719682,tract_part,http://www.prisonersofthecensus.org/data/2010blocks/360630234014023/
3.61E+14,720,13,4,0,53,3,244,1037,503,1540,67.33766234,32.66233766,institutionalized,http://www.prisonersofthecensus.org/data/2010blocks/360650266001002/
3.61E+14,612,13,6,0,76,10,270,987,321,1308,75.4587156,24.5412844,institutionalized,http://www.prisonersofthecensus.org/data/2010blocks/360650266001007/
3.61E+14,1033,22,6,0,110,10,429,1610,669,2279,70.64501975,29.35498025,tract,http://www.prisonersofthecensus.org/data/2010blocks/360650259001009/
3.61E+14,150,4,4,0,2,0,41,201,270,471,42.67515924,57.32484076,tract_part,http://www.prisonersofthecensus.org/data/2010blocks/360650261001010/
3.61E+14,203,16,2,0,23,20,57,321,198,519,61.84971098,38.15028902,tract,http://www.prisonersofthecensus.org/data/2010blocks/360670149001003/
3.61E+14,332,4,4,0,1,1,36,378,189,567,66.66666667,33.33333333,tract,http://www.prisonersofthecensus.org/data/2010blocks/360670032002057/
3.61E+14,1,0,0,0,0,0,1,2,1,3,66.66666667,33.33333333,tract,http://www.prisonersofthecensus.org/data/2010blocks/360670054003003/
3.61E+14,62,0,0,0,0,0,11,73,152,225,32.44444444,67.55555556,tract,http://www.prisonersofthecensus.org/data/2010blocks/360690512002017/
3.61E+14,234,4,9,0,124,5,184,560,212,772,72.5388601,27.4611399,tract_part,http://www.prisonersofthecensus.org/data/2010blocks/360710119001055/
3.61E+14,911,31,27,0,212,54,525,1760,322,2082,84.53410183,15.46589817,tract_part,http://www.prisonersofthecensus.org/data/2010blocks/360710115001002/
3.61E+14,9,0,0,0,2,0,3,14,1,15,93.33333333,6.666666667,tract,http://www.prisonersofthecensus.org/data/2010blocks/360710003004010/
3.61E+14,420,0,5,0,99,0,155,679,85,764,88.87434555,11.12565445,tract,http://www.prisonersofthecensus.org/data/2010blocks/360710147003000/
3.61E+14,22,0,0,0,0,0,2,24,43,67,35.82089552,64.17910448,tract_part,http://www.prisonersofthecensus.org/data/2010blocks/360730407004005/
3.61E+14,579,5,12,0,60,8,157,821,263,1084,75.73800738,24.26199262,institutionalized,http://www.prisonersofthecensus.org/data/2010blocks/360730406002040/
3.61E+14,419,5,4,1,6,3,102,540,414,954,56.60377358,43.39622642,institutionalized,http://www.prisonersofthecensus.org/data/2010blocks/360730406002055/
3.61E+14,8,1,0,0,3,0,10,22,109,131,16.79389313,83.20610687,tract,http://www.prisonersofthecensus.org/data/2010blocks/360750216043002/
3.61E+14,7,1,0,0,0,4,4,16,63,79,20.25316456,79.74683544,tract_part,http://www.prisonersofthecensus.org/data/2010blocks/360775901004100/
3.61E+14,10,0,0,0,1,0,15,26,97,123,21.13821138,78.86178862,tract,http://www.prisonersofthecensus.org/data/2010blocks/360790115001015/
3.61E+14,0,0,0,0,0,0,0,0,11,11,0,100,tract_part,http://www.prisonersofthecensus.org/data/2010blocks/360790114002014/
3.61E+14,15,0,6,0,13,6,28,68,114,182,37.36263736,62.63736264,tract,http://www.prisonersofthecensus.org/data/2010blocks/360790102001015/
3.61E+14,264,5,1,0,58,1,110,439,45,484,90.70247934,9.297520661,tract,http://www.prisonersofthecensus.org/data/2010blocks/360810199001004/
3.61E+14,5,0,0,0,0,0,3,8,2,10,80,20,tract,http://www.prisonersofthecensus.org/data/2010blocks/360810267002000/
3.61E+14,60,0,10,1,133,0,133,337,30,367,91.82561308,8.174386921,tract,http://www.prisonersofthecensus.org/data/2010blocks/360810320002023/
3.61E+14,1,0,6,0,0,0,0,7,0,7,100,0,tract,http://www.prisonersofthecensus.org/data/2010blocks/360810779081000/
3.61E+14,91,3,1,0,0,12,15,122,112,234,52.13675214,47.86324786,tract,http://www.prisonersofthecensus.org/data/2010blocks/360830410002004/
3.61E+14,1,0,0,0,0,0,1,2,4,6,33.33333333,66.66666667,tract,http://www.prisonersofthecensus.org/data/2010blocks/360850040007002/
3.61E+14,500,6,8,0,91,3,231,839,214,1053,79.67711301,20.32288699,tract,http://www.prisonersofthecensus.org/data/2010blocks/360850226001001/
3.61E+14,88,0,1,0,0,0,29,118,76,194,60.82474227,39.17525773,tract,http://www.prisonersofthecensus.org/data/2010blocks/360870108043004/
3.61E+14,0,0,0,0,0,0,1,1,9,10,10,90,tract_part,http://www.prisonersofthecensus.org/data/2010blocks/360894920004008/
3.61E+14,11,8,0,0,0,0,1,20,107,127,15.7480315,84.2519685,tract_part,http://www.prisonersofthecensus.org/data/2010blocks/360894921003074/
3.61E+14,615,7,8,0,127,1,231,989,145,1134,87.21340388,12.78659612,tract_part,http://www.prisonersofthecensus.org/data/2010blocks/360894927007007/
3.61E+14,495,6,4,0,103,1,193,802,131,933,85.95927117,14.04072883,institutionalized,http://www.prisonersofthecensus.org/data/2010blocks/360894914004031/
3.61E+14,236,1,3,0,67,0,96,403,69,472,85.38135593,14.61864407,institutionalized,http://www.prisonersofthecensus.org/data/2010blocks/360894914004037/
3.61E+14,0,0,0,0,1,0,0,1,3,4,25,75,tract,http://www.prisonersofthecensus.org/data/2010blocks/360910603002101/
3.61E+14,17,0,1,0,4,7,13,42,109,151,27.81456954,72.18543046,tract_part,http://www.prisonersofthecensus.org/data/2010blocks/360910614032001/
3.61E+14,233,2,2,0,21,1,79,338,161,499,67.73547094,32.26452906,tract,http://www.prisonersofthecensus.org/data/2010blocks/360910601013008/
3.61E+14,150,0,2,0,12,4,31,199,103,302,65.89403974,34.10596026,tract,http://www.prisonersofthecensus.org/data/2010blocks/360930210011022/
3.61E+14,58,1,0,0,8,0,13,80,61,141,56.73758865,43.26241135,tract_part,http://www.prisonersofthecensus.org/data/2010blocks/360957406002154/
3.61E+14,8,0,0,0,0,0,4,12,30,42,28.57142857,71.42857143,tract_part,http://www.prisonersofthecensus.org/data/2010blocks/360957401002007/
3.61E+14,0,0,1,0,0,0,0,1,18,19,5.263157895,94.73684211,tract_part,http://www.prisonersofthecensus.org/data/2010blocks/360979504004037/
3.61E+14,44,2,0,0,0,1,30,77,70,147,52.38095238,47.61904762,tract_part,http://www.prisonersofthecensus.org/data/2010blocks/360979503002080/
3.61E+14,862,8,4,0,75,1,243,1193,273,1466,81.37789905,18.62210095,institutionalized,http://www.prisonersofthecensus.org/data/2010blocks/360999508002207/
3.61E+14,19,0,0,0,0,0,5,24,62,86,27.90697674,72.09302326,institutionalized,http://www.prisonersofthecensus.org/data/2010blocks/360999508002257/
3.61E+14,366,7,6,0,34,0,78,491,210,701,70.04279601,29.95720399,institutionalized,http://www.prisonersofthecensus.org/data/2010blocks/360999508005115/
3.61E+14,33,0,0,0,0,0,21,54,118,172,31.39534884,68.60465116,tract_part,http://www.prisonersofthecensus.org/data/2010blocks/361019613001000/
3.61E+14,3,0,0,0,0,3,0,6,0,6,100,0,tract,http://www.prisonersofthecensus.org/data/2010blocks/361031225011014/
3.61E+14,214,1,1,0,0,0,163,379,253,632,59.96835443,40.03164557,tract_part,http://www.prisonersofthecensus.org/data/2010blocks/361031591063009/
3.61E+14,0,0,0,0,10,0,10,20,0,20,100,0,tract,http://www.prisonersofthecensus.org/data/2010blocks/361031109023013/
3.61E+14,392,3,2,0,1,3,206,607,452,1059,57.31822474,42.68177526,tract_part,http://www.prisonersofthecensus.org/data/2010blocks/361031904014008/
3.61E+14,1,0,0,0,0,1,6,8,1,9,88.88888889,11.11111111,tract,http://www.prisonersofthecensus.org/data/2010blocks/361059508001012/
3.61E+14,442,4,9,0,95,2,228,780,145,925,84.32432432,15.67567568,institutionalized,http://www.prisonersofthecensus.org/data/2010blocks/361059511002007/
3.61E+14,290,3,5,0,53,3,109,463,107,570,81.22807018,18.77192982,institutionalized,http://www.prisonersofthecensus.org/data/2010blocks/361059511002027/
3.61E+14,0,0,0,0,0,0,0,0,1,1,0,100,tract,http://www.prisonersofthecensus.org/data/2010blocks/361059525001044/
3.61E+14,48,2,1,0,3,3,33,90,68,158,56.96202532,43.03797468,tract_part,http://www.prisonersofthecensus.org/data/2010blocks/361059518002019/
3.61E+14,0,0,0,0,0,2,2,4,9,13,30.76923077,69.23076923,tract_part,http://www.prisonersofthecensus.org/data/2010blocks/361059515002077/
3.61E+14,8,0,0,0,0,1,1,10,79,89,11.23595506,88.76404494,tract,http://www.prisonersofthecensus.org/data/2010blocks/361070203002059/
3.61E+14,25,0,0,0,0,0,1,26,58,84,30.95238095,69.04761905,tract_part,http://www.prisonersofthecensus.org/data/2010blocks/361090015001026/
3.61E+14,7,0,0,0,1,0,0,8,2,10,80,20,tract,http://www.prisonersofthecensus.org/data/2010blocks/361119522004026/
3.61E+14,332,2,4,0,57,2,120,517,101,618,83.65695793,16.34304207,institutionalized,http://www.prisonersofthecensus.org/data/2010blocks/361119554002002/
3.61E+14,370,3,1,0,38,1,107,520,101,621,83.73590982,16.26409018,institutionalized,http://www.prisonersofthecensus.org/data/2010blocks/361119554002051/
3.61E+14,456,3,5,0,45,4,172,685,114,799,85.73216521,14.26783479,institutionalized,http://www.prisonersofthecensus.org/data/2010blocks/361119545002026/
3.61E+14,616,7,10,0,82,5,266,986,151,1137,86.71943712,13.28056288,institutionalized,http://www.prisonersofthecensus.org/data/2010blocks/361119545002030/
3.61E+14,2,0,0,0,0,0,1,3,16,19,15.78947368,84.21052632,tract,http://www.prisonersofthecensus.org/data/2010blocks/361130702001004/
3.61E+14,44,3,0,0,3,5,8,63,96,159,39.62264151,60.37735849,tract,http://www.prisonersofthecensus.org/data/2010blocks/361130706012043/
3.61E+14,984,12,10,0,122,3,302,1433,369,1802,79.5227525,20.4772475,institutionalized,http://www.prisonersofthecensus.org/data/2010blocks/361150810002018/
3.61E+14,515,9,4,0,39,1,141,709,178,887,79.93235626,20.06764374,institutionalized,http://www.prisonersofthecensus.org/data/2010blocks/361150810004005/
3.61E+14,11,0,0,0,3,5,10,29,90,119,24.3697479,75.6302521,tract_part,http://www.prisonersofthecensus.org/data/2010blocks/361150880001012/
3.61E+14,38,2,0,0,4,0,8,52,22,74,70.27027027,29.72972973,tract_part,http://www.prisonersofthecensus.org/data/2010blocks/361170216001004/
3.61E+14,0,0,0,0,20,0,20,40,0,40,100,0,institutionalized,http://www.prisonersofthecensus.org/data/2010blocks/361170215011035/
3.61E+14,0,0,0,0,17,0,17,34,0,34,100,0,institutionalized,http://www.prisonersofthecensus.org/data/2010blocks/361170215011037/
3.61E+14,42,0,0,0,0,0,18,60,79,139,43.16546763,56.83453237,tract_part,http://www.prisonersofthecensus.org/data/2010blocks/361170210002038/
3.61E+14,96,1,1,0,10,0,20,128,47,175,73.14285714,26.85714286,tract_part,http://www.prisonersofthecensus.org/data/2010blocks/361170215022076/
3.61E+14,153,0,6,0,2,0,55,216,116,332,65.06024096,34.93975904,institutionalized,http://www.prisonersofthecensus.org/data/2010blocks/361199830001006/
3.61E+14,423,4,7,0,11,1,103,549,273,822,66.78832117,33.21167883,institutionalized,http://www.prisonersofthecensus.org/data/2010blocks/361199830001013/
3.61E+14,818,3,2,7,91,9,225,1155,307,1462,79.00136799,20.99863201,tract,http://www.prisonersofthecensus.org/data/2010blocks/361199810001040/
3.61E+14,1157,6,10,0,129,4,408,1714,242,1956,87.62781186,12.37218814,tract,http://www.prisonersofthecensus.org/data/2010blocks/361199820001000/
3.61E+14,931,12,11,0,132,1,265,1352,410,1762,76.73098751,23.26901249,institutionalized,http://www.prisonersofthecensus.org/data/2010blocks/361219702001022/
3.61E+14,1341,20,3,0,170,1,332,1867,492,2359,79.14370496,20.85629504,institutionalized,http://www.prisonersofthecensus.org/data/2010blocks/361219702001024/
3.61E+14,0,0,0,0,0,0,2,2,45,47,4.255319149,95.74468085,tract_part,http://www.prisonersofthecensus.org/data/2010blocks/361219705005015/
3.61E+14,17,0,0,0,0,0,0,17,39,56,30.35714286,69.64285714,tract_part,http://www.prisonersofthecensus.org/data/2010blocks/361231502003002/
3.70E+14,35,0,0,0,1,4,24,64,10,74,86.48648649,13.51351351,tract_part,http://www.prisonersofthecensus.org/data/2010blocks/370010211021002/
3.70E+14,7,0,0,0,0,0,0,7,14,21,33.33333333,66.66666667,tract_part,http://www.prisonersofthecensus.org/data/2010blocks/370030404002004/
3.70E+14,520,19,3,0,9,1,12,564,410,974,57.90554415,42.09445585,tract_part,http://www.prisonersofthecensus.org/data/2010blocks/370030406001008/
3.70E+14,1,0,0,0,1,1,3,6,10,16,37.5,62.5,tract_part,http://www.prisonersofthecensus.org/data/2010blocks/370059502001056/
3.70E+14,1343,44,17,1,68,1,263,1737,519,2256,76.99468085,23.00531915,tract_part,http://www.prisonersofthecensus.org/data/2010blocks/370079203004011/
3.70E+14,51,1,0,0,2,0,2,56,17,73,76.71232877,23.28767123,tract_part,http://www.prisonersofthecensus.org/data/2010blocks/370079205005011/
3.70E+14,1,0,0,0,0,0,8,9,32,41,21.95121951,78.04878049,tract_part,http://www.prisonersofthecensus.org/data/2010blocks/370099705004026/
3.70E+14,579,17,9,0,41,3,54,703,1079,1782,39.45005612,60.54994388,tract_part,http://www.prisonersofthecensus.org/data/2010blocks/370119304001047/
3.70E+14,1,0,0,0,0,0,1,2,28,30,6.666666667,93.33333333,tract_part,http://www.prisonersofthecensus.org/data/2010blocks/370119303012019/
3.70E+14,58,0,0,0,5,0,9,72,22,94,76.59574468,23.40425532,tract_part,http://www.prisonersofthecensus.org/data/2010blocks/370139303002022/
3.70E+14,721,22,0,0,5,27,29,804,164,968,83.05785124,16.94214876,tract_part,http://www.prisonersofthecensus.org/data/2010blocks/370159604002015/
3.70E+14,109,0,0,0,0,3,1,113,17,130,86.92307692,13.07692308,tract_part,http://www.prisonersofthecensus.org/data/2010blocks/370159604002034/
3.70E+14,95,4,0,0,0,1,0,100,63,163,61.34969325,38.65030675,tract_part,http://www.prisonersofthecensus.org/data/2010blocks/370179501004013/
3.70E+14,39,0,0,0,0,0,3,42,22,64,65.625,34.375,tract_part,http://www.prisonersofthecensus.org/data/2010blocks/370179504002002/
3.70E+14,79,0,0,0,0,0,9,88,166,254,34.64566929,65.35433071,tract_part,http://www.prisonersofthecensus.org/data/2010blocks/370190206031017/
3.70E+14,122,0,3,0,0,4,28,157,289,446,35.20179372,64.79820628,tract,http://www.prisonersofthecensus.org/data/2010blocks/370210001001056/
3.70E+14,37,3,2,0,0,3,4,49,116,165,29.6969697,70.3030303,tract_part,http://www.prisonersofthecensus.org/data/2010blocks/370210031041041/
3.70E+14,156,5,1,0,17,1,21,201,390,591,34.01015228,65.98984772,tract_part,http://www.prisonersofthecensus.org/data/2010blocks/370210027012027/
3.70E+14,10,0,0,0,0,0,0,10,34,44,22.72727273,77.27272727,tract_part,http://www.prisonersofthecensus.org/data/2010blocks/370230206003039/
3.70E+14,51,0,4,0,0,0,1,56,100,156,35.8974359,64.1025641,tract_part,http://www.prisonersofthecensus.org/data/2010blocks/370230214004012/
3.70E+14,1065,4,5,1,64,4,71,1214,390,1604,75.68578554,24.31421446,tract_part,http://www.prisonersofthecensus.org/data/2010blocks/370230213013039/
3.70E+14,112,1,0,0,3,0,3,119,80,199,59.79899497,40.20100503,tract_part,http://www.prisonersofthecensus.org/data/2010blocks/370250417012036/
3.70E+14,41,0,0,0,0,0,17,58,30,88,65.90909091,34.09090909,tract_part,http://www.prisonersofthecensus.org/data/2010blocks/370250422001002/
3.70E+14,115,0,0,0,0,0,13,128,128,256,50,50,tract,http://www.prisonersofthecensus.org/data/2010blocks/370250423004017/
3.70E+14,78,1,0,0,2,0,2,83,157,240,34.58333333,65.41666667,tract_part,http://www.prisonersofthecensus.org/data/2010blocks/370270304004045/
3.70E+14,52,0,0,0,0,0,16,68,125,193,35.23316062,64.76683938,tract_part,http://www.prisonersofthecensus.org/data/2010blocks/370270303002013/
3.70E+14,24,0,0,1,0,0,1,26,88,114,22.80701754,77.19298246,tract_part,http://www.prisonersofthecensus.org/data/2010blocks/370319703031073/
3.70E+14,0,0,1,0,0,0,0,1,1,2,50,50,tract_part,http://www.prisonersofthecensus.org/data/2010blocks/370319710021018/
3.70E+14,176,3,2,0,0,0,4,185,101,286,64.68531469,35.31468531,tract_part,http://www.prisonersofthecensus.org/data/2010blocks/370319707033004/
3.70E+14,267,10,2,2,23,23,38,365,146,511,71.42857143,28.57142857,institutionalized,http://www.prisonersofthecensus.org/data/2010blocks/370339302004001/
3.70E+14,12,0,0,0,0,0,1,13,9,22,59.09090909,40.90909091,institutionalized,http://www.prisonersofthecensus.org/data/2010blocks/370339302004024/
3.70E+14,349,6,1,1,17,1,52,427,216,643,66.40746501,33.59253499,tract_part,http://www.prisonersofthecensus.org/data/2010blocks/370339302002038/
3.70E+14,74,1,0,0,1,0,2,78,115,193,40.41450777,59.58549223,tract_part,http://www.prisonersofthecensus.org/data/2010blocks/370350116013028/
3.70E+14,91,0,0,0,0,0,9,100,114,214,46.72897196,53.27102804,tract_part,http://www.prisonersofthecensus.org/data/2010blocks/370350112002043/
3.70E+14,17,0,0,0,0,0,13,30,18,48,62.5,37.5,tract_part,http://www.prisonersofthecensus.org/data/2010blocks/370370208004002/
3.70E+14,7,10,0,0,0,0,8,25,83,108,23.14814815,76.85185185,tract_part,http://www.prisonersofthecensus.org/data/2010blocks/370399304004048/
3.70E+14,18,0,0,0,0,0,0,18,5,23,78.26086957,21.73913043,tract_part,http://www.prisonersofthecensus.org/data/2010blocks/370419301012042/
3.70E+14,59,0,0,0,0,0,3,62,46,108,57.40740741,42.59259259,tract,http://www.prisonersofthecensus.org/data/2010blocks/370459510004009/
3.70E+14,44,0,0,0,0,0,3,47,36,83,56.62650602,43.37349398,tract,http://www.prisonersofthecensus.org/data/2010blocks/370459511003034/
3.70E+14,1015,36,13,0,30,5,11,1110,363,1473,75.35641548,24.64358452,tract_part,http://www.prisonersofthecensus.org/data/2010blocks/370479312003014/
3.70E+14,386,24,4,1,30,6,49,500,223,723,69.15629322,30.84370678,tract_part,http://www.prisonersofthecensus.org/data/2010blocks/370479310003056/
3.70E+14,127,2,0,0,1,0,7,137,64,201,68.15920398,31.84079602,tract_part,http://www.prisonersofthecensus.org/data/2010blocks/370479309003006/
3.71E+14,477,30,7,1,20,9,38,582,202,784,74.23469388,25.76530612,tract_part,http://www.prisonersofthecensus.org/data/2010blocks/370499602001036/
3.71E+14,105,0,2,0,3,0,7,117,67,184,63.58695652,36.41304348,tract_part,http://www.prisonersofthecensus.org/data/2010blocks/370499609001041/
3.71E+14,365,15,1,0,3,0,16,400,147,547,73.1261426,26.8738574,tract,http://www.prisonersofthecensus.org/data/2010blocks/370510038002060/
3.71E+14,8,0,0,0,0,0,0,8,30,38,21.05263158,78.94736842,tract_part,http://www.prisonersofthecensus.org/data/2010blocks/370531103022008/
3.71E+14,7,1,0,0,0,1,4,13,43,56,23.21428571,76.78571429,tract_part,http://www.prisonersofthecensus.org/data/2010blocks/370559706011014/
3.71E+14,80,1,0,0,0,0,14,95,132,227,41.85022026,58.14977974,tract,http://www.prisonersofthecensus.org/data/2010blocks/370570613001050/
3.71E+14,191,2,0,0,5,1,9,208,170,378,55.02645503,44.97354497,tract_part,http://www.prisonersofthecensus.org/data/2010blocks/370570614001021/
3.71E+14,9,0,0,0,0,0,1,10,32,42,23.80952381,76.19047619,tract_part,http://www.prisonersofthecensus.org/data/2010blocks/370590801004048/
3.71E+14,177,8,0,0,7,1,8,201,129,330,60.90909091,39.09090909,tract_part,http://www.prisonersofthecensus.org/data/2010blocks/370610904003001/
3.71E+14,2,0,0,0,0,0,0,2,0,2,100,0,tract,http://www.prisonersofthecensus.org/data/2010blocks/370630001021007/
3.71E+14,14,0,0,0,0,0,0,14,3,17,82.35294118,17.64705882,tract,http://www.prisonersofthecensus.org/data/2010blocks/370630002003022/
3.71E+14,162,0,0,0,3,0,3,168,42,210,80,20,tract_part,http://www.prisonersofthecensus.org/data/2010blocks/370630017111008/
3.71E+14,418,1,0,0,14,0,46,479,63,542,88.37638376,11.62361624,tract,http://www.prisonersofthecensus.org/data/2010blocks/370630023001007/
3.71E+14,188,0,1,0,8,0,14,211,31,242,87.19008264,12.80991736,tract_part,http://www.prisonersofthecensus.org/data/2010blocks/370650212004002/
3.71E+14,25,4,0,0,0,2,1,32,69,101,31.68316832,68.31683168,tract_part,http://www.prisonersofthecensus.org/data/2010blocks/370650212001025/
3.71E+14,194,8,1,0,4,0,1,208,291,499,41.68336673,58.31663327,tract_part,http://www.prisonersofthecensus.org/data/2010blocks/370650206001069/
3.71E+14,452,1,1,0,0,0,74,528,240,768,68.75,31.25,tract,http://www.prisonersofthecensus.org/data/2010blocks/370670001001053/
3.71E+14,162,0,2,0,2,0,2,168,81,249,67.46987952,32.53012048,tract,http://www.prisonersofthecensus.org/data/2010blocks/370670014002001/
3.71E+14,3,0,0,0,0,0,0,3,2,5,60,40,tract,http://www.prisonersofthecensus.org/data/2010blocks/370670017003001/
3.71E+14,350,5,3,0,3,2,16,379,101,480,78.95833333,21.04166667,tract_part,http://www.prisonersofthecensus.org/data/2010blocks/370690608012030/
3.71E+14,2,0,0,0,0,0,0,2,0,2,100,0,tract,http://www.prisonersofthecensus.org/data/2010blocks/370690608022018/
3.71E+14,96,1,1,0,6,0,12,116,44,160,72.5,27.5,tract_part,http://www.prisonersofthecensus.org/data/2010blocks/370690603021012/
3.71E+14,114,0,1,0,0,0,3,118,120,238,49.57983193,50.42016807,tract_part,http://www.prisonersofthecensus.org/data/2010blocks/370710304023029/
3.71E+14,183,0,0,0,1,0,18,202,254,456,44.29824561,55.70175439,tract,http://www.prisonersofthecensus.org/data/2010blocks/370710320003055/
3.71E+14,0,0,0,0,0,0,0,0,6,6,0,100,tract_part,http://www.prisonersofthecensus.org/data/2010blocks/370759203003020/
3.71E+14,722,5,3,0,16,0,62,808,171,979,82.53319714,17.46680286,tract_part,http://www.prisonersofthecensus.org/data/2010blocks/370779707032002/
3.71E+14,2150,101,24,2,249,123,639,3288,1661,4949,66.43766417,33.56233583,tract_part,http://www.prisonersofthecensus.org/data/2010blocks/370779707041005/
3.71E+14,45,0,0,0,0,0,3,48,31,79,60.75949367,39.24050633,tract_part,http://www.prisonersofthecensus.org/data/2010blocks/370779702002037/
3.71E+14,592,11,5,0,29,5,146,788,351,1139,69.18349429,30.81650571,tract_part,http://www.prisonersofthecensus.org/data/2010blocks/370799501021000/
3.71E+14,583,33,5,0,48,19,88,776,310,1086,71.45488029,28.54511971,tract_part,http://www.prisonersofthecensus.org/data/2010blocks/370799501022039/
3.71E+14,26,0,0,0,1,2,1,30,10,40,75,25,tract_part,http://www.prisonersofthecensus.org/data/2010blocks/370810108002003/
3.71E+14,203,4,3,0,0,0,4,214,101,315,67.93650794,32.06349206,tract,http://www.prisonersofthecensus.org/data/2010blocks/370810139002020/
3.71E+14,336,3,0,0,1,1,39,380,111,491,77.39307536,22.60692464,tract_part,http://www.prisonersofthecensus.org/data/2010blocks/370810108002052/
3.71E+14,105,1,0,0,3,0,12,121,34,155,78.06451613,21.93548387,tract_part,http://www.prisonersofthecensus.org/data/2010blocks/370810152001011/
3.71E+14,306,9,0,0,4,1,5,325,112,437,74.37070938,25.62929062,institutionalized,http://www.prisonersofthecensus.org/data/2010blocks/370839310002000/
3.71E+14,400,13,2,1,8,0,24,448,128,576,77.77777778,22.22222222,institutionalized,http://www.prisonersofthecensus.org/data/2010blocks/370839310002011/
3.71E+14,506,14,0,0,25,1,143,689,319,1008,68.3531746,31.6468254,tract_part,http://www.prisonersofthecensus.org/data/2010blocks/370850707003020/
3.71E+14,28,3,0,0,0,0,2,33,92,125,26.4,73.6,tract_part,http://www.prisonersofthecensus.org/data/2010blocks/370879212005021/
3.71E+14,11,2,0,0,13,1,42,69,86,155,44.51612903,55.48387097,tract_part,http://www.prisonersofthecensus.org/data/2010blocks/370899312001018/
3.71E+14,53,1,0,0,0,0,1,55,9,64,85.9375,14.0625,tract_part,http://www.prisonersofthecensus.org/data/2010blocks/370919502003008/
3.71E+14,718,0,6,0,0,0,212,936,317,1253,74.70071828,25.29928172,tract_part,http://www.prisonersofthecensus.org/data/2010blocks/370919502003004/
3.71E+14,193,5,0,0,1,2,2,203,118,321,63.23987539,36.76012461,tract_part,http://www.prisonersofthecensus.org/data/2010blocks/370939702012085/
3.71E+14,82,13,0,0,10,0,14,119,24,143,83.21678322,16.78321678,tract_part,http://www.prisonersofthecensus.org/data/2010blocks/370939703005010/
3.71E+14,521,14,6,0,23,1,5,570,187,757,75.29722589,24.70277411,tract_part,http://www.prisonersofthecensus.org/data/2010blocks/370959201001229/
3.71E+14,17,0,0,0,2,0,2,21,31,52,40.38461538,59.61538462,tract_part,http://www.prisonersofthecensus.org/data/2010blocks/370970607032010/
3.71E+14,124,0,1,0,16,1,31,173,116,289,59.8615917,40.1384083,tract,http://www.prisonersofthecensus.org/data/2010blocks/370970605002033/
3.71E+14,85,4,0,0,15,1,28,133,60,193,68.9119171,31.0880829,tract_part,http://www.prisonersofthecensus.org/data/2010blocks/371010408001005/
3.71E+14,379,18,3,0,5,1,30,436,221,657,66.36225266,33.63774734,tract_part,http://www.prisonersofthecensus.org/data/2010blocks/371010409012090/
3.71E+14,15,0,0,0,0,0,1,16,1,17,94.11764706,5.882352941,tract_part,http://www.prisonersofthecensus.org/data/2010blocks/371039202001130/
3.71E+14,47,1,0,0,0,0,22,70,33,103,67.96116505,32.03883495,tract_part,http://www.prisonersofthecensus.org/data/2010blocks/371050303002060/
3.71E+14,180,6,1,0,0,0,7,194,98,292,66.43835616,33.56164384,tract_part,http://www.prisonersofthecensus.org/data/2010blocks/371050303002001/
3.71E+14,97,0,0,0,0,0,0,97,17,114,85.0877193,14.9122807,tract_part,http://www.prisonersofthecensus.org/data/2010blocks/371070107002060/
3.71E+14,106,1,0,0,0,0,2,109,82,191,57.06806283,42.93193717,tract_part,http://www.prisonersofthecensus.org/data/2010blocks/371090702012001/
3.71E+14,334,8,4,0,59,2,65,472,374,846,55.79196217,44.20803783,tract_part,http://www.prisonersofthecensus.org/data/2010blocks/371119709011073/
3.71E+14,14,0,0,0,1,0,5,20,96,116,17.24137931,82.75862069,tract_part,http://www.prisonersofthecensus.org/data/2010blocks/371119705002032/
3.71E+14,0,0,0,0,0,0,1,1,30,31,3.225806452,96.77419355,tract_part,http://www.prisonersofthecensus.org/data/2010blocks/371150105002097/
3.71E+14,977,1,3,0,6,1,128,1116,303,1419,78.64693446,21.35306554,institutionalized,http://www.prisonersofthecensus.org/data/2010blocks/371190006002035/
3.71E+14,67,0,0,0,0,0,3,70,18,88,79.54545455,20.45454545,institutionalized,http://www.prisonersofthecensus.org/data/2010blocks/371190006002047/
3.71E+14,0,0,0,0,0,0,0,0,1,1,0,100,tract,http://www.prisonersofthecensus.org/data/2010blocks/371190017024007/
3.71E+14,10,0,0,0,2,0,6,18,7,25,72,28,tract,http://www.prisonersofthecensus.org/data/2010blocks/371190019154004/
3.71E+14,5,0,0,0,0,0,1,6,14,20,30,70,tract,http://www.prisonersofthecensus.org/data/2010blocks/371190036001016/
3.71E+14,167,1,0,0,2,0,8,178,68,246,72.35772358,27.64227642,tract,http://www.prisonersofthecensus.org/data/2010blocks/371190039031006/
3.71E+14,3,0,0,0,0,0,1,4,0,4,100,0,tract,http://www.prisonersofthecensus.org/data/2010blocks/371190045002010/
3.71E+14,383,1,3,0,4,1,60,452,108,560,80.71428571,19.28571429,tract,http://www.prisonersofthecensus.org/data/2010blocks/371190061091002/
3.71E+14,203,15,2,0,5,1,14,240,294,534,44.94382022,55.05617978,tract_part,http://www.prisonersofthecensus.org/data/2010blocks/371239602003001/
3.71E+14,178,8,1,0,12,1,16,216,120,336,64.28571429,35.71428571,tract_part,http://www.prisonersofthecensus.org/data/2010blocks/371239602003002/
3.71E+14,514,14,5,0,4,14,15,566,392,958,59.08141962,40.91858038,tract_part,http://www.prisonersofthecensus.org/data/2010blocks/371270111021002/
3.71E+14,220,7,1,0,0,3,2,233,160,393,59.28753181,40.71246819,tract_part,http://www.prisonersofthecensus.org/data/2010blocks/371290115004047/
3.71E+14,270,1,0,0,0,0,3,274,210,484,56.61157025,43.38842975,tract_part,http://www.prisonersofthecensus.org/data/2010blocks/371290116031021/
3.71E+14,12,1,0,0,0,1,0,14,8,22,63.63636364,36.36363636,tract,http://www.prisonersofthecensus.org/data/2010blocks/371290101002040/
3.71E+14,0,0,0,0,0,0,0,0,15,15,0,100,tract,http://www.prisonersofthecensus.org/data/2010blocks/371290119022013/
3.71E+14,51,0,0,0,1,0,1,53,7,60,88.33333333,11.66666667,tract_part,http://www.prisonersofthecensus.org/data/2010blocks/371319203005009/
3.71E+14,315,6,1,0,2,2,8,334,132,466,71.67381974,28.32618026,tract_part,http://www.prisonersofthecensus.org/data/2010blocks/371319203005015/
3.71E+14,32,2,1,0,13,11,30,89,90,179,49.72067039,50.27932961,tract_part,http://www.prisonersofthecensus.org/data/2010blocks/371330006002096/
3.71E+14,93,0,1,1,2,4,11,112,95,207,54.10628019,45.89371981,tract,http://www.prisonersofthecensus.org/data/2010blocks/371330018001031/
3.71E+14,0,1,0,0,0,0,1,2,3,5,40,60,tract_part,http://www.prisonersofthecensus.org/data/2010blocks/371330001032022/
3.71E+14,135,2,0,0,2,0,2,141,68,209,67.46411483,32.53588517,tract_part,http://www.prisonersofthecensus.org/data/2010blocks/371350109022036/
3.71E+14,80,0,0,0,1,0,23,104,56,160,65,35,tract_part,http://www.prisonersofthecensus.org/data/2010blocks/371350110002023/
3.71E+14,20,1,0,0,0,0,2,23,21,44,52.27272727,47.72727273,tract_part,http://www.prisonersofthecensus.org/data/2010blocks/371379501022024/
3.71E+14,367,14,1,0,0,0,27,409,166,575,71.13043478,28.86956522,tract_part,http://www.prisonersofthecensus.org/data/2010blocks/371379501021075/
3.71E+14,81,0,0,0,0,0,1,82,45,127,64.56692913,35.43307087,tract_part,http://www.prisonersofthecensus.org/data/2010blocks/371399604004018/
3.71E+14,687,16,4,0,0,3,21,731,184,915,79.89071038,20.10928962,tract_part,http://www.prisonersofthecensus.org/data/2010blocks/371399605022005/
3.71E+14,352,19,0,0,14,3,62,450,313,763,58.97771953,41.02228047,tract_part,http://www.prisonersofthecensus.org/data/2010blocks/371419204022010/
3.71E+14,31,1,0,0,0,0,2,34,37,71,47.88732394,52.11267606,tract_part,http://www.prisonersofthecensus.org/data/2010blocks/371419204032038/
3.71E+14,48,0,0,0,0,0,2,50,25,75,66.66666667,33.33333333,tract_part,http://www.prisonersofthecensus.org/data/2010blocks/371459203001044/
3.71E+14,344,0,0,0,0,0,4,348,83,431,80.7424594,19.2575406,tract_part,http://www.prisonersofthecensus.org/data/2010blocks/371470008002046/
3.71E+14,0,0,0,0,0,1,0,1,13,14,7.142857143,92.85714286,tract_part,http://www.prisonersofthecensus.org/data/2010blocks/371499201042086/
3.72E+14,48,0,0,0,10,4,40,102,110,212,48.11320755,51.88679245,tract_part,http://www.prisonersofthecensus.org/data/2010blocks/371510301002038/
3.72E+14,108,5,0,0,0,0,1,114,106,220,51.81818182,48.18181818,tract_part,http://www.prisonersofthecensus.org/data/2010blocks/371510301002036/
3.72E+14,442,7,4,0,9,2,67,531,211,742,71.56334232,28.43665768,tract_part,http://www.prisonersofthecensus.org/data/2010blocks/371539701002001/
3.72E+14,37,1,0,0,0,0,7,45,44,89,50.56179775,49.43820225,tract_part,http://www.prisonersofthecensus.org/data/2010blocks/371539705002034/
3.72E+14,383,49,6,0,82,2,134,656,221,877,74.8004561,25.1995439,institutionalized,http://www.prisonersofthecensus.org/data/2010blocks/371559608011036/
3.72E+14,122,150,0,0,1,0,15,288,47,335,85.97014925,14.02985075,remaining,http://www.prisonersofthecensus.org/data/2010blocks/371559608011037/
3.72E+14,136,42,0,0,1,2,0,181,96,277,65.34296029,34.65703971,tract_part,http://www.prisonersofthecensus.org/data/2010blocks/371559606003066/
3.72E+14,43,2,0,0,6,0,2,53,49,102,51.96078431,48.03921569,tract_part,http://www.prisonersofthecensus.org/data/2010blocks/371559601021002/
3.72E+14,67,0,0,0,6,0,15,88,53,141,62.41134752,37.58865248,tract_part,http://www.prisonersofthecensus.org/data/2010blocks/371570416012000/
3.72E+14,137,0,0,0,1,0,2,140,126,266,52.63157895,47.36842105,institutionalized,http://www.prisonersofthecensus.org/data/2010blocks/371590512011031/
3.72E+14,350,5,2,1,23,0,28,409,349,758,53.95778364,46.04221636,institutionalized,http://www.prisonersofthecensus.org/data/2010blocks/371590512012003/
3.72E+14,94,0,0,0,5,0,18,117,136,253,46.24505929,53.75494071,tract_part,http://www.prisonersofthecensus.org/data/2010blocks/371590520001018/
3.72E+14,44,0,0,0,1,0,4,49,113,162,30.24691358,69.75308642,tract_part,http://www.prisonersofthecensus.org/data/2010blocks/371619605004010/
3.72E+14,84,2,1,0,0,0,0,87,150,237,36.70886076,63.29113924,tract_part,http://www.prisonersofthecensus.org/data/2010blocks/371619606002015/
3.72E+14,240,12,12,0,25,0,5,294,220,514,57.19844358,42.80155642,tract_part,http://www.prisonersofthecensus.org/data/2010blocks/371639706001042/
3.72E+14,71,21,0,0,0,0,0,92,38,130,70.76923077,29.23076923,tract_part,http://www.prisonersofthecensus.org/data/2010blocks/371650102002040/
3.72E+14,610,40,1,0,14,0,62,727,238,965,75.33678756,24.66321244,tract_part,http://www.prisonersofthecensus.org/data/2010blocks/371650104001003/
3.72E+14,283,6,2,0,44,2,95,432,188,620,69.67741935,30.32258065,tract_part,http://www.prisonersofthecensus.org/data/2010blocks/371679302001003/
3.72E+14,37,0,0,0,0,0,4,41,44,85,48.23529412,51.76470588,tract_part,http://www.prisonersofthecensus.org/data/2010blocks/371679312011039/
3.72E+14,10,0,0,0,2,0,5,17,64,81,20.98765432,79.01234568,tract_part,http://www.prisonersofthecensus.org/data/2010blocks/371690702003014/
3.72E+14,13,0,0,0,0,0,28,41,85,126,32.53968254,67.46031746,tract_part,http://www.prisonersofthecensus.org/data/2010blocks/371719310021017/
3.72E+14,4,0,0,0,3,2,5,14,49,63,22.22222222,77.77777778,tract_part,http://www.prisonersofthecensus.org/data/2010blocks/371759603001015/
3.72E+14,469,2,1,1,3,0,3,479,150,629,76.15262321,23.84737679,tract_part,http://www.prisonersofthecensus.org/data/2010blocks/371779601001015/
3.72E+14,134,2,0,0,12,2,28,178,74,252,70.63492063,29.36507937,tract_part,http://www.prisonersofthecensus.org/data/2010blocks/371790207021046/
3.72E+14,94,0,0,0,0,1,3,98,24,122,80.32786885,19.67213115,tract,http://www.prisonersofthecensus.org/data/2010blocks/371819605003038/
3.72E+14,6,0,0,0,1,0,3,10,0,10,100,0,tract_part,http://www.prisonersofthecensus.org/data/2010blocks/371830537093016/
3.72E+14,368,0,0,0,2,0,16,386,158,544,70.95588235,29.04411765,tract,http://www.prisonersofthecensus.org/data/2010blocks/371830501001088/
3.72E+14,860,25,6,1,10,6,42,950,830,1780,53.37078652,46.62921348,tract,http://www.prisonersofthecensus.org/data/2010blocks/371830508003006/
3.72E+14,576,0,0,0,0,0,0,576,294,870,66.20689655,33.79310345,tract,http://www.prisonersofthecensus.org/data/2010blocks/371830511023004/
3.72E+14,226,1,1,0,2,0,3,233,167,400,58.25,41.75,tract_part,http://www.prisonersofthecensus.org/data/2010blocks/371830545002026/
3.72E+14,619,13,5,1,16,5,38,697,240,937,74.38633938,25.61366062,tract_part,http://www.prisonersofthecensus.org/data/2010blocks/371859502005024/
3.72E+14,5,0,0,0,1,2,12,20,37,57,35.0877193,64.9122807,tract_part,http://www.prisonersofthecensus.org/data/2010blocks/371899204003015/
3.72E+14,313,13,4,0,15,8,20,373,343,716,52.09497207,47.90502793,institutionalized,http://www.prisonersofthecensus.org/data/2010blocks/371910011011021/
3.72E+14,281,7,1,2,11,6,18,326,116,442,73.75565611,26.24434389,institutionalized,http://www.prisonersofthecensus.org/data/2010blocks/371910011011024/
3.72E+14,1,0,0,0,2,0,2,5,17,22,22.72727273,77.27272727,tract_part,http://www.prisonersofthecensus.org/data/2010blocks/371939606001055/
3.72E+14,96,1,0,0,0,0,1,98,125,223,43.94618834,56.05381166,tract_part,http://www.prisonersofthecensus.org/data/2010blocks/371939611002003/
3.72E+14,12,0,0,0,0,0,3,15,60,75,20,80,tract_part,http://www.prisonersofthecensus.org/data/2010blocks/371939611003012/
3.72E+14,0,0,0,0,0,0,1,1,8,9,11.11111111,88.88888889,tract,http://www.prisonersofthecensus.org/data/2010blocks/371950001001018/
3.72E+14,119,1,1,0,4,2,16,143,35,178,80.33707865,19.66292135,tract,http://www.prisonersofthecensus.org/data/2010blocks/371950002001001/
3.72E+14,6,0,0,0,0,0,3,9,36,45,20,80,tract_part,http://www.prisonersofthecensus.org/data/2010blocks/371970505011015/
3.72E+14,0,0,0,0,0,0,3,3,30,33,9.090909091,90.90909091,tract_part,http://www.prisonersofthecensus.org/data/2010blocks/371999602003058/
3.80E+14,1,1,0,0,1,0,1,4,14,18,22.22222222,77.77777778,tract_part,http://www.prisonersofthecensus.org/data/2010blocks/380039683002027/
3.80E+14,0,13,0,0,0,0,0,13,0,13,100,0,tract_part,http://www.prisonersofthecensus.org/data/2010blocks/380059401002007/
3.80E+14,0,5,0,0,1,0,2,8,2,10,80,20,tract_part,http://www.prisonersofthecensus.org/data/2010blocks/380099523002017/
3.80E+14,10,40,0,0,4,0,4,58,55,113,51.32743363,48.67256637,tract,http://www.prisonersofthecensus.org/data/2010blocks/380150101003018/
3.80E+14,4,17,0,0,1,0,1,23,64,87,26.43678161,73.56321839,institutionalized,http://www.prisonersofthecensus.org/data/2010blocks/380150108002031/
3.80E+14,1,13,0,0,1,0,2,17,30,47,36.17021277,63.82978723,institutionalized,http://www.prisonersofthecensus.org/data/2010blocks/380150108002032/
3.80E+14,39,115,1,0,10,3,31,199,328,527,37.76091082,62.23908918,tract_part,http://www.prisonersofthecensus.org/data/2010blocks/380150109002025/
3.80E+14,0,1,0,0,0,0,0,1,3,4,25,75,tract_part,http://www.prisonersofthecensus.org/data/2010blocks/380150113003092/
3.80E+14,10,29,0,0,3,1,11,54,98,152,35.52631579,64.47368421,tract_part,http://www.prisonersofthecensus.org/data/2010blocks/380150112003034/
3.80E+14,2,2,1,0,0,0,0,5,20,25,20,80,tract,http://www.prisonersofthecensus.org/data/2010blocks/380170005011039/
3.80E+14,7,46,1,4,4,5,10,77,97,174,44.25287356,55.74712644,tract,http://www.prisonersofthecensus.org/data/2010blocks/380170006001109/
3.80E+14,6,44,0,0,12,5,22,89,100,189,47.08994709,52.91005291,tract_part,http://www.prisonersofthecensus.org/data/2010blocks/380350117001138/
3.80E+14,2,34,0,0,0,3,3,42,75,117,35.8974359,64.1025641,tract_part,http://www.prisonersofthecensus.org/data/2010blocks/380419648001169/
3.81E+14,0,1,0,0,0,0,0,1,5,6,16.66666667,83.33333333,tract_part,http://www.prisonersofthecensus.org/data/2010blocks/380539624001082/
3.81E+14,0,0,0,0,0,0,0,0,1,1,0,100,tract_part,http://www.prisonersofthecensus.org/data/2010blocks/380539625001543/
3.81E+14,0,2,0,0,0,1,1,4,6,10,40,60,tract_part,http://www.prisonersofthecensus.org/data/2010blocks/380559608005037/
3.81E+14,0,0,0,0,0,0,0,0,6,6,0,100,tract_part,http://www.prisonersofthecensus.org/data/2010blocks/380579618002531/
3.81E+14,1,11,0,0,0,2,1,15,14,29,51.72413793,48.27586207,tract_part,http://www.prisonersofthecensus.org/data/2010blocks/380590201002022/
3.81E+14,0,0,0,0,0,0,0,0,3,3,0,100,tract_part,http://www.prisonersofthecensus.org/data/2010blocks/380619552001020/
3.81E+14,0,1,0,0,0,0,0,1,6,7,14.28571429,85.71428571,tract_part,http://www.prisonersofthecensus.org/data/2010blocks/380679503002047/
3.81E+14,4,67,0,0,11,0,12,94,47,141,66.66666667,33.33333333,tract_part,http://www.prisonersofthecensus.org/data/2010blocks/380699561001383/
3.81E+14,5,65,0,0,0,0,6,76,23,99,76.76767677,23.23232323,tract_part,http://www.prisonersofthecensus.org/data/2010blocks/380719578002050/
3.81E+14,2,0,0,0,0,0,1,3,12,15,20,80,tract_part,http://www.prisonersofthecensus.org/data/2010blocks/380779710003061/
3.81E+14,0,10,0,0,0,0,0,10,1,11,90.90909091,9.090909091,tract_part,http://www.prisonersofthecensus.org/data/2010blocks/380799516002074/
3.81E+14,0,24,0,0,0,0,1,25,0,25,100,0,tract_part,http://www.prisonersofthecensus.org/data/2010blocks/380799418004016/
3.81E+14,2,26,0,0,0,1,0,29,12,41,70.73170732,29.26829268,tract_part,http://www.prisonersofthecensus.org/data/2010blocks/380859409002042/
3.81E+14,0,31,0,0,0,0,0,31,32,63,49.20634921,50.79365079,tract_part,http://www.prisonersofthecensus.org/data/2010blocks/380899634003005/
3.81E+14,29,94,0,0,2,8,20,153,268,421,36.34204276,63.65795724,tract_part,http://www.prisonersofthecensus.org/data/2010blocks/380939673001078/
3.81E+14,3,10,0,1,6,0,8,28,52,80,35,65,tract_part,http://www.prisonersofthecensus.org/data/2010blocks/380939678005074/
3.81E+14,0,0,0,0,0,0,0,0,3,3,0,100,tract_part,http://www.prisonersofthecensus.org/data/2010blocks/380979704001080/
3.81E+14,1,1,0,0,1,1,1,5,14,19,26.31578947,73.68421053,tract_part,http://www.prisonersofthecensus.org/data/2010blocks/380999579001015/
3.81E+14,4,15,0,0,0,1,0,20,52,72,27.77777778,72.22222222,tract,http://www.prisonersofthecensus.org/data/2010blocks/381010101001063/
3.81E+14,0,8,0,0,0,0,1,9,21,30,30,70,tract_part,http://www.prisonersofthecensus.org/data/2010blocks/381059541003145/
3.90E+14,1,0,0,0,0,0,0,1,50,51,1.960784314,98.03921569,tract_part,http://www.prisonersofthecensus.org/data/2010blocks/390017704003017/
3.90E+14,949,0,11,0,65,16,332,1373,1597,2970,46.22895623,53.77104377,tract_part,http://www.prisonersofthecensus.org/data/2010blocks/390030112001026/
3.90E+14,4,0,0,0,0,0,2,6,10,16,37.5,62.5,tract,http://www.prisonersofthecensus.org/data/2010blocks/390030134001020/
3.90E+14,105,0,0,0,0,0,1,106,88,194,54.63917526,45.36082474,tract,http://www.prisonersofthecensus.org/data/2010blocks/390030141002006/
3.90E+14,829,2,2,0,19,0,54,906,618,1524,59.4488189,40.5511811,tract_part,http://www.prisonersofthecensus.org/data/2010blocks/390070001013062/
3.90E+14,0,0,0,0,0,0,0,0,2,2,0,100,tract_part,http://www.prisonersofthecensus.org/data/2010blocks/390070008023008/
3.90E+14,4,0,0,0,0,0,2,6,28,34,17.64705882,82.35294118,tract_part,http://www.prisonersofthecensus.org/data/2010blocks/390070011022020/
3.90E+14,0,0,0,0,0,0,0,0,10,10,0,100,tract_part,http://www.prisonersofthecensus.org/data/2010blocks/390099739021032/
3.90E+14,9,1,1,0,1,4,4,20,259,279,7.168458781,92.83154122,tract_part,http://www.prisonersofthecensus.org/data/2010blocks/390099728001037/
3.90E+14,3,0,0,0,0,0,1,4,50,54,7.407407407,92.59259259,tract_part,http://www.prisonersofthecensus.org/data/2010blocks/390110404005012/
3.90E+14,1516,0,2,1,14,3,77,1613,1099,2712,59.47640118,40.52359882,tract_part,http://www.prisonersofthecensus.org/data/2010blocks/390130122001007/
3.90E+14,4,0,0,0,0,1,0,5,63,68,7.352941176,92.64705882,tract_part,http://www.prisonersofthecensus.org/data/2010blocks/390159518002003/
3.90E+14,183,2,3,0,30,18,77,313,434,747,41.90093708,58.09906292,tract,http://www.prisonersofthecensus.org/data/2010blocks/390170004003014/
3.90E+14,0,0,0,0,0,0,0,0,2,2,0,100,tract_part,http://www.prisonersofthecensus.org/data/2010blocks/390170006003012/
3.90E+14,24,0,0,0,0,3,0,27,144,171,15.78947368,84.21052632,tract,http://www.prisonersofthecensus.org/data/2010blocks/390170146002034/
3.90E+14,15,0,0,0,1,1,2,19,44,63,30.15873016,69.84126984,tract,http://www.prisonersofthecensus.org/data/2010blocks/390170144001017/
3.90E+14,1,0,0,0,0,0,0,1,16,17,5.882352941,94.11764706,tract_part,http://www.prisonersofthecensus.org/data/2010blocks/390197205005016/
3.90E+14,14,2,0,0,1,5,5,27,128,155,17.41935484,82.58064516,tract_part,http://www.prisonersofthecensus.org/data/2010blocks/390210115051009/
3.90E+14,56,1,0,0,7,9,15,88,126,214,41.12149533,58.87850467,tract_part,http://www.prisonersofthecensus.org/data/2010blocks/390230034003039/
3.90E+14,14,0,0,0,0,0,2,16,289,305,5.245901639,94.75409836,tract_part,http://www.prisonersofthecensus.org/data/2010blocks/390250410003028/
3.90E+14,2,0,0,0,0,0,2,4,55,59,6.779661017,93.22033898,tract_part,http://www.prisonersofthecensus.org/data/2010blocks/390279647001004/
3.90E+14,2,0,0,0,0,2,0,4,21,25,16,84,tract_part,http://www.prisonersofthecensus.org/data/2010blocks/390299511003047/
3.90E+14,13,0,0,0,0,0,1,14,107,121,11.57024793,88.42975207,tract_part,http://www.prisonersofthecensus.org/data/2010blocks/390299511002050/
3.90E+14,1157,45,35,1,127,77,391,1833,881,2714,67.53868828,32.46131172,tract_part,http://www.prisonersofthecensus.org/data/2010blocks/390299514002016/
3.90E+14,1,0,0,0,0,0,0,1,49,50,2,98,tract_part,http://www.prisonersofthecensus.org/data/2010blocks/390319613002019/
3.90E+14,32,0,0,0,10,1,18,61,63,124,49.19354839,50.80645161,tract_part,http://www.prisonersofthecensus.org/data/2010blocks/390339744001047/
3.90E+14,23,0,7,0,7,0,19,56,12,68,82.35294118,17.64705882,tract,http://www.prisonersofthecensus.org/data/2010blocks/390351331041027/
3.90E+14,2,0,0,0,0,0,1,3,0,3,100,0,tract,http://www.prisonersofthecensus.org/data/2010blocks/390351371023005/
3.90E+14,1405,1,3,1,84,0,71,1565,516,2081,75.20422874,24.79577126,tract,http://www.prisonersofthecensus.org/data/2010blocks/390351071011032/
3.90E+14,76,0,0,0,4,0,4,84,37,121,69.4214876,30.5785124,tract,http://www.prisonersofthecensus.org/data/2010blocks/390351083012006/
3.90E+14,110,0,1,0,1,0,7,119,129,248,47.98387097,52.01612903,tract,http://www.prisonersofthecensus.org/data/2010blocks/390351097012002/
3.90E+14,149,0,0,0,7,0,10,166,64,230,72.17391304,27.82608696,tract,http://www.prisonersofthecensus.org/data/2010blocks/390351123011011/
3.90E+14,71,0,0,0,0,0,22,93,7,100,93,7,tract,http://www.prisonersofthecensus.org/data/2010blocks/390351236021003/
3.90E+14,9,0,0,0,0,3,0,12,15,27,44.44444444,55.55555556,institutionalized,http://www.prisonersofthecensus.org/data/2010blocks/390351514002005/
3.90E+14,22,0,0,0,0,0,1,23,0,23,100,0,institutionalized,http://www.prisonersofthecensus.org/data/2010blocks/390351514003006/
3.90E+14,39,0,0,0,0,0,1,40,18,58,68.96551724,31.03448276,tract,http://www.prisonersofthecensus.org/data/2010blocks/390351525021000/
3.90E+14,10,0,0,0,0,0,0,10,4,14,71.42857143,28.57142857,tract,http://www.prisonersofthecensus.org/data/2010blocks/390351546032002/
3.90E+14,1,0,0,0,0,0,0,1,0,1,100,0,tract,http://www.prisonersofthecensus.org/data/2010blocks/390351551012026/
3.90E+14,162,0,0,0,1,1,10,174,50,224,77.67857143,22.32142857,tract_part,http://www.prisonersofthecensus.org/data/2010blocks/390351939001006/
3.90E+14,1,0,0,0,0,0,0,1,3,4,25,75,tract,http://www.prisonersofthecensus.org/data/2010blocks/390351701023007/
3.90E+14,1,0,0,0,0,0,0,1,1,2,50,50,tract,http://www.prisonersofthecensus.org/data/2010blocks/390351722012000/
3.90E+14,1,0,0,0,0,0,0,1,11,12,8.333333333,91.66666667,tract,http://www.prisonersofthecensus.org/data/2010blocks/390351776083002/
3.90E+14,1,0,0,0,0,0,0,1,0,1,100,0,tract,http://www.prisonersofthecensus.org/data/2010blocks/390351801042002/
3.90E+14,4,0,0,0,0,0,0,4,1,5,80,20,tract,http://www.prisonersofthecensus.org/data/2010blocks/390351835023011/
3.90E+14,0,0,0,0,0,0,0,0,1,1,0,100,tract,http://www.prisonersofthecensus.org/data/2010blocks/390351841042018/
3.90E+14,4,0,0,0,0,0,1,5,1,6,83.33333333,16.66666667,tract,http://www.prisonersofthecensus.org/data/2010blocks/390351851041006/
3.90E+14,2,0,0,0,0,0,0,2,2,4,50,50,tract,http://www.prisonersofthecensus.org/data/2010blocks/390351861062014/
3.90E+14,2,0,0,0,0,0,0,2,27,29,6.896551724,93.10344828,tract_part,http://www.prisonersofthecensus.org/data/2010blocks/390375551011131/
3.90E+14,40,0,0,0,3,1,23,67,132,199,33.66834171,66.33165829,tract_part,http://www.prisonersofthecensus.org/data/2010blocks/390410102003001/
3.90E+14,35,0,0,0,0,0,3,38,56,94,40.42553191,59.57446809,tract,http://www.prisonersofthecensus.org/data/2010blocks/390430414002018/
3.90E+14,626,1,3,0,11,0,25,666,881,1547,43.05106658,56.94893342,tract_part,http://www.prisonersofthecensus.org/data/2010blocks/390450325002034/
3.90E+14,5,0,0,0,0,0,0,5,90,95,5.263157895,94.73684211,tract,http://www.prisonersofthecensus.org/data/2010blocks/390450320004018/
3.90E+14,13,0,0,0,0,0,1,14,75,89,15.73033708,84.26966292,tract,http://www.prisonersofthecensus.org/data/2010blocks/390450322003018/
3.90E+14,9,0,0,0,0,0,0,9,68,77,11.68831169,88.31168831,tract_part,http://www.prisonersofthecensus.org/data/2010blocks/390450323002005/
3.90E+14,4,0,0,0,0,0,0,4,30,34,11.76470588,88.23529412,tract_part,http://www.prisonersofthecensus.org/data/2010blocks/390479260004010/
3.90E+14,0,0,2,0,0,0,0,2,2,4,50,50,tract,http://www.prisonersofthecensus.org/data/2010blocks/390490018203008/
3.90E+14,18,0,0,0,0,1,2,21,40,61,34.42622951,65.57377049,institutionalized,http://www.prisonersofthecensus.org/data/2010blocks/390490038001034/
3.90E+14,21,0,0,0,0,2,0,23,5,28,82.14285714,17.85714286,institutionalized,http://www.prisonersofthecensus.org/data/2010blocks/390490038001035/
3.90E+14,5,0,0,0,0,1,2,8,14,22,36.36363636,63.63636364,tract,http://www.prisonersofthecensus.org/data/2010blocks/390490053003006/
3.90E+14,192,1,0,0,1,0,6,200,397,597,33.50083752,66.49916248,tract_part,http://www.prisonersofthecensus.org/data/2010blocks/390490083403006/
3.90E+14,677,5,1,0,22,16,56,777,598,1375,56.50909091,43.49090909,tract_part,http://www.prisonersofthecensus.org/data/2010blocks/390490083803007/
3.90E+14,153,2,0,0,1,5,6,167,130,297,56.22895623,43.77104377,tract,http://www.prisonersofthecensus.org/data/2010blocks/390490087302021/
3.91E+14,5,0,0,0,0,0,0,5,30,35,14.28571429,85.71428571,tract_part,http://www.prisonersofthecensus.org/data/2010blocks/390539540003012/
3.91E+14,8,0,0,0,0,1,0,9,39,48,18.75,81.25,tract,http://www.prisonersofthecensus.org/data/2010blocks/390553108003026/
3.91E+14,26,1,0,0,2,1,2,32,87,119,26.8907563,73.1092437,tract_part,http://www.prisonersofthecensus.org/data/2010blocks/390572402001015/
3.91E+14,44,1,0,0,3,0,0,48,105,153,31.37254902,68.62745098,tract_part,http://www.prisonersofthecensus.org/data/2010blocks/390572406005007/
3.91E+14,9,0,0,0,0,0,2,11,50,61,18.03278689,81.96721311,tract_part,http://www.prisonersofthecensus.org/data/2010blocks/390599773003000/
3.91E+14,871,16,4,1,15,47,68,1022,464,1486,68.77523553,31.22476447,tract,http://www.prisonersofthecensus.org/data/2010blocks/390610007001000/
3.91E+14,57,1,0,0,0,2,5,65,53,118,55.08474576,44.91525424,institutionalized,http://www.prisonersofthecensus.org/data/2010blocks/390610028001014/
3.91E+14,66,2,0,0,2,6,2,78,130,208,37.5,62.5,institutionalized,http://www.prisonersofthecensus.org/data/2010blocks/390610028001027/
3.91E+14,12,0,1,0,0,0,0,13,36,49,26.53061224,73.46938776,tract,http://www.prisonersofthecensus.org/data/2010blocks/390610037001019/
3.91E+14,1,0,0,0,0,0,0,1,0,1,100,0,tract_part,http://www.prisonersofthecensus.org/data/2010blocks/390610057022000/
3.91E+14,11,1,1,0,0,1,1,15,36,51,29.41176471,70.58823529,tract,http://www.prisonersofthecensus.org/data/2010blocks/390610272002011/
3.91E+14,15,0,0,0,2,2,16,35,90,125,28,72,tract_part,http://www.prisonersofthecensus.org/data/2010blocks/390630009003009/
3.91E+14,4,1,0,0,0,0,0,5,64,69,7.246376812,92.75362319,tract_part,http://www.prisonersofthecensus.org/data/2010blocks/390719548001002/
3.91E+14,84,0,0,0,2,0,3,89,396,485,18.35051546,81.64948454,tract_part,http://www.prisonersofthecensus.org/data/2010blocks/390739655002073/
3.91E+14,1,0,0,0,0,0,0,1,27,28,3.571428571,96.42857143,tract_part,http://www.prisonersofthecensus.org/data/2010blocks/390759764004026/
3.91E+14,7,0,0,0,0,0,3,10,85,95,10.52631579,89.47368421,tract_part,http://www.prisonersofthecensus.org/data/2010blocks/390779156004029/
3.91E+14,0,0,0,0,0,0,0,0,37,37,0,100,tract_part,http://www.prisonersofthecensus.org/data/2010blocks/390799575001012/
3.91E+14,2,0,0,0,0,1,0,3,69,72,4.166666667,95.83333333,tract_part,http://www.prisonersofthecensus.org/data/2010blocks/390810114024013/
3.91E+14,15,0,0,0,0,2,1,18,34,52,34.61538462,65.38461538,tract_part,http://www.prisonersofthecensus.org/data/2010blocks/390810002002093/
3.91E+14,1,1,0,0,0,0,1,3,50,53,5.660377358,94.33962264,tract_part,http://www.prisonersofthecensus.org/data/2010blocks/390830073002028/
3.91E+14,58,2,1,0,3,9,11,84,217,301,27.90697674,72.09302326,tract,http://www.prisonersofthecensus.org/data/2010blocks/390852045001009/
3.91E+14,6,0,0,0,0,0,0,6,84,90,6.666666667,93.33333333,tract_part,http://www.prisonersofthecensus.org/data/2010blocks/390870503001035/
3.91E+14,23,3,1,0,0,9,3,39,196,235,16.59574468,83.40425532,tract_part,http://www.prisonersofthecensus.org/data/2010blocks/390897525004054/
3.91E+14,0,0,0,0,0,2,0,2,11,13,15.38461538,84.61538462,institutionalized,http://www.prisonersofthecensus.org/data/2010blocks/390897590003034/
3.91E+14,0,0,0,0,0,0,0,0,16,16,0,100,institutionalized,http://www.prisonersofthecensus.org/data/2010blocks/390897590003041/
3.91E+14,150,0,0,0,3,0,42,195,198,393,49.61832061,50.38167939,tract_part,http://www.prisonersofthecensus.org/data/2010blocks/390930715001006/
3.91E+14,1035,1,0,0,27,3,37,1103,769,1872,58.92094017,41.07905983,tract_part,http://www.prisonersofthecensus.org/data/2010blocks/390930912001011/
3.91E+14,1076,3,4,0,30,3,45,1161,946,2107,55.10204082,44.89795918,institutionalized,http://www.prisonersofthecensus.org/data/2010blocks/390930951001003/
3.91E+14,48,0,0,0,1,0,1,50,66,116,43.10344828,56.89655172,institutionalized,http://www.prisonersofthecensus.org/data/2010blocks/390930951001004/
3.91E+14,5,0,0,0,0,0,1,6,4,10,60,40,tract,http://www.prisonersofthecensus.org/data/2010blocks/390930973003007/
3.91E+14,653,2,0,0,11,2,27,695,486,1181,58.84843353,41.15156647,tract,http://www.prisonersofthecensus.org/data/2010blocks/390950012021017/
3.91E+14,205,0,1,0,12,5,31,254,146,400,63.5,36.5,tract,http://www.prisonersofthecensus.org/data/2010blocks/390950028001016/
3.91E+14,30,0,0,0,1,4,8,43,28,71,60.56338028,39.43661972,tract,http://www.prisonersofthecensus.org/data/2010blocks/390950030001026/
3.91E+14,1045,1,4,0,17,0,37,1104,1227,2331,47.36164736,52.63835264,institutionalized,http://www.prisonersofthecensus.org/data/2010blocks/390970410001000/
3.91E+14,1074,5,5,3,18,5,48,1158,1407,2565,45.14619883,54.85380117,institutionalized,http://www.prisonersofthecensus.org/data/2010blocks/390970410001007/
3.91E+14,2,0,0,0,0,0,0,2,2,4,50,50,tract,http://www.prisonersofthecensus.org/data/2010blocks/390998106001036/
3.91E+14,606,29,87,3,324,133,1261,2443,208,2651,92.15390419,7.846095813,tract,http://www.prisonersofthecensus.org/data/2010blocks/390998005003000/
3.91E+14,16,0,0,0,0,0,0,16,27,43,37.20930233,62.79069767,institutionalized,http://www.prisonersofthecensus.org/data/2010blocks/390998021001003/
3.91E+14,43,0,0,0,2,0,3,48,51,99,48.48484848,51.51515152,institutionalized,http://www.prisonersofthecensus.org/data/2010blocks/390998021001005/
3.91E+14,239,0,6,0,2,1,14,262,178,440,59.54545455,40.45454545,institutionalized,http://www.prisonersofthecensus.org/data/2010blocks/390998137004015/
3.91E+14,8,0,0,0,0,0,0,8,25,33,24.24242424,75.75757576,institutionalized,http://www.prisonersofthecensus.org/data/2010blocks/390998137004017/
3.91E+14,304,0,0,0,3,1,11,319,227,546,58.42490842,41.57509158,tract,http://www.prisonersofthecensus.org/data/2010blocks/390998138002040/
3.91E+14,876,2,2,0,11,1,79,971,1362,2333,41.62023146,58.37976854,institutionalized,http://www.prisonersofthecensus.org/data/2010blocks/391010102021022/
3.91E+14,1155,4,3,0,8,3,51,1224,1067,2291,53.42645133,46.57354867,institutionalized,http://www.prisonersofthecensus.org/data/2010blocks/391010102021032/
3.91E+14,20,0,0,0,0,0,3,23,132,155,14.83870968,85.16129032,institutionalized,http://www.prisonersofthecensus.org/data/2010blocks/391010102021035/
3.91E+14,16,0,0,0,0,0,2,18,118,136,13.23529412,86.76470588,tract_part,http://www.prisonersofthecensus.org/data/2010blocks/391034082012030/
3.91E+14,0,0,0,0,0,0,0,0,2,2,0,100,tract_part,http://www.prisonersofthecensus.org/data/2010blocks/391059644004032/
3.91E+14,0,0,0,0,0,0,0,0,8,8,0,100,tract_part,http://www.prisonersofthecensus.org/data/2010blocks/391059645001011/
3.91E+14,2,0,0,0,0,0,0,2,24,26,7.692307692,92.30769231,tract_part,http://www.prisonersofthecensus.org/data/2010blocks/391079674003031/
3.91E+14,13,1,0,0,0,2,2,18,82,100,18,82,tract_part,http://www.prisonersofthecensus.org/data/2010blocks/391093653015013/
3.91E+14,396,0,1,0,1,1,7,406,379,785,51.71974522,48.28025478,tract,http://www.prisonersofthecensus.org/data/2010blocks/391130015011072/
3.91E+14,0,0,0,0,0,0,0,0,15,15,0,100,institutionalized,http://www.prisonersofthecensus.org/data/2010blocks/391130034022008/
3.91E+14,0,0,0,0,0,0,0,0,6,6,0,100,institutionalized,http://www.prisonersofthecensus.org/data/2010blocks/391130034022016/
3.91E+14,0,0,0,0,0,0,0,0,5,5,0,100,institutionalized,http://www.prisonersofthecensus.org/data/2010blocks/391130034022018/
3.91E+14,213,1,0,0,0,4,5,223,167,390,57.17948718,42.82051282,tract_part,http://www.prisonersofthecensus.org/data/2010blocks/391130603003000/
3.91E+14,292,0,0,0,1,0,16,309,189,498,62.04819277,37.95180723,tract_part,http://www.prisonersofthecensus.org/data/2010blocks/391130603003001/
3.91E+14,5,0,1,0,0,2,28,36,42,78,46.15384615,53.84615385,tract_part,http://www.prisonersofthecensus.org/data/2010blocks/391179652005005/
3.91E+14,36,0,1,0,0,0,0,37,122,159,23.27044025,76.72955975,tract_part,http://www.prisonersofthecensus.org/data/2010blocks/391199119001080/
3.91E+14,9,0,0,0,0,0,0,9,31,40,22.5,77.5,tract_part,http://www.prisonersofthecensus.org/data/2010blocks/391199120003028/
3.91E+14,1,0,0,0,0,0,0,1,17,18,5.555555556,94.44444444,tract_part,http://www.prisonersofthecensus.org/data/2010blocks/391219684002090/
3.91E+14,353,4,0,0,5,7,8,377,2158,2535,14.87179487,85.12820513,tract_part,http://www.prisonersofthecensus.org/data/2010blocks/391219684004017/
3.91E+14,3,0,0,0,0,0,1,4,39,43,9.302325581,90.69767442,institutionalized,http://www.prisonersofthecensus.org/data/2010blocks/391230505003002/
3.91E+14,2,0,0,0,0,0,0,2,30,32,6.25,93.75,institutionalized,http://www.prisonersofthecensus.org/data/2010blocks/391230505004002/
3.91E+14,11,0,0,0,0,1,4,16,100,116,13.79310345,86.20689655,tract_part,http://www.prisonersofthecensus.org/data/2010blocks/391290203201069/
3.91E+14,1351,1,13,0,29,1,73,1468,2158,3626,40.48538334,59.51461666,tract_part,http://www.prisonersofthecensus.org/data/2010blocks/391290213001000/
3.91E+14,0,0,0,0,0,0,0,0,51,51,0,100,tract_part,http://www.prisonersofthecensus.org/data/2010blocks/391319522004276/
3.91E+14,39,0,0,0,1,1,5,46,135,181,25.41436464,74.58563536,tract,http://www.prisonersofthecensus.org/data/2010blocks/391336005005029/
3.91E+14,1,1,0,0,2,2,3,9,25,34,26.47058824,73.52941176,tract_part,http://www.prisonersofthecensus.org/data/2010blocks/391354550021021/
3.91E+14,3,0,0,0,0,0,0,3,64,67,4.47761194,95.52238806,tract_part,http://www.prisonersofthecensus.org/data/2010blocks/391354001003000/
3.91E+14,2,1,0,0,0,0,0,3,28,31,9.677419355,90.32258065,tract_part,http://www.prisonersofthecensus.org/data/2010blocks/391390009003002/
3.91E+14,1545,3,3,0,7,1,76,1635,886,2521,64.85521618,35.14478382,institutionalized,http://www.prisonersofthecensus.org/data/2010blocks/391390017001084/
3.91E+14,1457,0,2,0,7,4,76,1546,1026,2572,60.1088647,39.8911353,institutionalized,http://www.prisonersofthecensus.org/data/2010blocks/391390017001105/
3.91E+14,11,1,0,0,0,0,1,13,51,64,20.3125,79.6875,institutionalized,http://www.prisonersofthecensus.org/data/2010blocks/391390031001057/
3.91E+14,59,0,0,0,0,0,2,61,129,190,32.10526316,67.89473684,institutionalized,http://www.prisonersofthecensus.org/data/2010blocks/391390031001157/
3.91E+14,17,0,0,0,1,0,5,23,156,179,12.84916201,87.15083799,tract_part,http://www.prisonersofthecensus.org/data/2010blocks/391419563003003/
3.91E+14,1,0,0,0,0,0,0,1,21,22,4.545454545,95.45454545,tract_part,http://www.prisonersofthecensus.org/data/2010blocks/391419556011009/
3.91E+14,1224,3,8,0,14,1,59,1309,1615,2924,44.76744186,55.23255814,institutionalized,http://www.prisonersofthecensus.org/data/2010blocks/391419556021006/
3.91E+14,1131,4,9,0,12,1,36,1193,1356,2549,46.80266771,53.19733229,institutionalized,http://www.prisonersofthecensus.org/data/2010blocks/391419556021008/
3.91E+14,21,0,0,0,0,0,2,23,44,67,34.32835821,65.67164179,tract_part,http://www.prisonersofthecensus.org/data/2010blocks/391439617001054/
3.91E+14,8,0,0,0,0,0,0,8,118,126,6.349206349,93.65079365,tract_part,http://www.prisonersofthecensus.org/data/2010blocks/391450028002013/
3.91E+14,20,0,0,0,0,0,1,21,137,158,13.29113924,86.70886076,tract,http://www.prisonersofthecensus.org/data/2010blocks/391450037002006/
3.91E+14,786,1,1,0,1,1,16,806,609,1415,56.96113074,43.03886926,tract_part,http://www.prisonersofthecensus.org/data/2010blocks/391450022004005/
3.91E+14,13,0,0,0,0,0,1,14,72,86,16.27906977,83.72093023,institutionalized,http://www.prisonersofthecensus.org/data/2010blocks/391479637004005/
3.91E+14,32,0,14,0,47,5,63,161,99,260,61.92307692,38.07692308,remaining,http://www.prisonersofthecensus.org/data/2010blocks/391479637004006/
3.92E+14,21,1,0,0,0,0,7,29,75,104,27.88461538,72.11538462,tract_part,http://www.prisonersofthecensus.org/data/2010blocks/391499722004015/
3.92E+14,186,4,0,0,2,13,12,217,336,553,39.24050633,60.75949367,tract_part,http://www.prisonersofthecensus.org/data/2010blocks/391517124003041/
3.92E+14,2,0,0,0,0,0,0,2,12,14,14.28571429,85.71428571,tract_part,http://www.prisonersofthecensus.org/data/2010blocks/391517116004045/
3.92E+14,31,0,1,1,3,0,13,49,76,125,39.2,60.8,institutionalized,http://www.prisonersofthecensus.org/data/2010blocks/391535011001008/
3.92E+14,12,0,0,0,0,0,0,12,41,53,22.64150943,77.35849057,institutionalized,http://www.prisonersofthecensus.org/data/2010blocks/391535011001009/
3.92E+14,11,0,0,0,0,2,1,14,14,28,50,50,tract,http://www.prisonersofthecensus.org/data/2010blocks/391535017002005/
3.92E+14,0,0,0,0,0,0,0,0,3,3,0,100,tract,http://www.prisonersofthecensus.org/data/2010blocks/391535027001013/
3.92E+14,13,0,0,0,2,0,2,17,28,45,37.77777778,62.22222222,tract,http://www.prisonersofthecensus.org/data/2010blocks/391535042003007/
3.92E+14,244,1,2,0,5,8,13,273,354,627,43.54066986,56.45933014,institutionalized,http://www.prisonersofthecensus.org/data/2010blocks/391535068001060/
3.92E+14,74,0,0,0,2,0,1,77,76,153,50.32679739,49.67320261,institutionalized,http://www.prisonersofthecensus.org/data/2010blocks/391535068001077/
3.92E+14,1,0,0,0,0,0,0,1,16,17,5.882352941,94.11764706,tract_part,http://www.prisonersofthecensus.org/data/2010blocks/391535075004015/
3.92E+14,1,0,0,0,0,0,0,1,4,5,20,80,tract_part,http://www.prisonersofthecensus.org/data/2010blocks/391535327011058/
3.92E+14,4,0,0,0,0,0,0,4,1,5,80,20,tract,http://www.prisonersofthecensus.org/data/2010blocks/391535301044009/
3.92E+14,15,0,0,0,1,0,0,16,111,127,12.5984252,87.4015748,tract_part,http://www.prisonersofthecensus.org/data/2010blocks/391559205001000/
3.92E+14,830,2,2,2,6,1,55,898,476,1374,65.356623,34.643377,tract_part,http://www.prisonersofthecensus.org/data/2010blocks/391559207005024/
3.92E+14,79,0,0,0,0,0,3,82,196,278,29.49640288,70.50359712,tract,http://www.prisonersofthecensus.org/data/2010blocks/391559338004002/
3.92E+14,9,0,0,0,1,1,1,12,93,105,11.42857143,88.57142857,tract_part,http://www.prisonersofthecensus.org/data/2010blocks/391570210004057/
3.92E+14,16,3,0,0,0,7,3,29,108,137,21.16788321,78.83211679,tract_part,http://www.prisonersofthecensus.org/data/2010blocks/391590503031051/
3.92E+14,783,0,11,0,2,2,21,819,1780,2599,31.51212005,68.48787995,tract_part,http://www.prisonersofthecensus.org/data/2010blocks/391590504004004/
3.92E+14,3,0,0,0,1,0,1,5,46,51,9.803921569,90.19607843,tract_part,http://www.prisonersofthecensus.org/data/2010blocks/391610206002059/
3.92E+14,0,0,0,0,0,0,0,0,4,4,0,100,tract_part,http://www.prisonersofthecensus.org/data/2010blocks/391610201002092/
3.92E+14,43,2,0,0,2,4,3,54,127,181,29.83425414,70.16574586,tract_part,http://www.prisonersofthecensus.org/data/2010blocks/391650313002010/
3.92E+14,32,1,0,0,1,2,6,42,142,184,22.82608696,77.17391304,institutionalized,http://www.prisonersofthecensus.org/data/2010blocks/391650317001000/
3.92E+14,847,1,0,0,1,1,8,858,573,1431,59.95807128,40.04192872,institutionalized,http://www.prisonersofthecensus.org/data/2010blocks/391650317001005/
3.92E+14,1523,2,1,0,5,3,24,1558,1229,2787,55.90240402,44.09759598,institutionalized,http://www.prisonersofthecensus.org/data/2010blocks/391650317001008/
3.92E+14,13,0,0,0,0,0,0,13,95,108,12.03703704,87.96296296,tract_part,http://www.prisonersofthecensus.org/data/2010blocks/391670204001015/
3.92E+14,13,0,0,0,0,6,2,21,98,119,17.64705882,82.35294118,tract_part,http://www.prisonersofthecensus.org/data/2010blocks/391690006001033/
3.92E+14,221,1,0,0,0,3,40,265,271,536,49.44029851,50.55970149,tract_part,http://www.prisonersofthecensus.org/data/2010blocks/391719505004001/
3.92E+14,29,0,0,0,6,2,19,56,169,225,24.88888889,75.11111111,tract_part,http://www.prisonersofthecensus.org/data/2010blocks/391730225002060/
3.92E+14,1,0,0,0,0,0,1,2,16,18,11.11111111,88.88888889,tract_part,http://www.prisonersofthecensus.org/data/2010blocks/391759384003001/
4.00E+14,0,10,0,0,0,5,0,15,10,25,60,40,tract_part,http://www.prisonersofthecensus.org/data/2010blocks/400013769003132/
4.00E+14,1,0,0,0,0,0,0,1,10,11,9.090909091,90.90909091,tract_part,http://www.prisonersofthecensus.org/data/2010blocks/400039556002299/
4.00E+14,211,77,5,0,26,32,102,453,582,1035,43.76811594,56.23188406,tract_part,http://www.prisonersofthecensus.org/data/2010blocks/400039560002006/
4.00E+14,8,8,0,0,1,0,1,18,39,57,31.57894737,68.42105263,tract_part,http://www.prisonersofthecensus.org/data/2010blocks/400055877004048/
4.00E+14,202,71,2,0,21,0,30,326,342,668,48.80239521,51.19760479,tract_part,http://www.prisonersofthecensus.org/data/2010blocks/400055879002172/
4.00E+14,0,0,0,0,2,1,4,7,7,14,50,50,tract_part,http://www.prisonersofthecensus.org/data/2010blocks/400079518001055/
4.00E+14,28,2,1,0,2,0,7,40,52,92,43.47826087,56.52173913,tract_part,http://www.prisonersofthecensus.org/data/2010blocks/400099661006034/
4.00E+14,456,25,49,1,208,27,861,1627,211,1838,88.52013058,11.47986942,remaining,http://www.prisonersofthecensus.org/data/2010blocks/400099668002016/
4.00E+14,20,4,0,0,0,0,1,25,37,62,40.32258065,59.67741935,institutionalized,http://www.prisonersofthecensus.org/data/2010blocks/400099668003053/
4.00E+14,7,7,3,1,247,36,2047,2348,3,2351,99.87239473,0.127605274,institutionalized,http://www.prisonersofthecensus.org/data/2010blocks/400119589002005/
4.00E+14,5,10,0,0,0,0,1,16,17,33,48.48484848,51.51515152,institutionalized,http://www.prisonersofthecensus.org/data/2010blocks/400119589003056/
4.00E+14,4,11,0,0,0,0,7,22,72,94,23.40425532,76.59574468,tract,http://www.prisonersofthecensus.org/data/2010blocks/400137963002032/
4.00E+14,4,40,0,0,0,0,0,44,45,89,49.43820225,50.56179775,tract_part,http://www.prisonersofthecensus.org/data/2010blocks/400151621005048/
4.00E+14,338,74,4,0,152,57,478,1103,762,1865,59.14209115,40.85790885,tract_part,http://www.prisonersofthecensus.org/data/2010blocks/400151616002189/
4.00E+14,0,1,0,0,0,0,0,1,0,1,100,0,tract_part,http://www.prisonersofthecensus.org/data/2010blocks/400151618003278/
4.00E+14,10,13,0,0,2,3,9,37,42,79,46.83544304,53.16455696,tract_part,http://www.prisonersofthecensus.org/data/2010blocks/400173004002009/
4.00E+14,521,56,16,0,1,2,277,873,606,1479,59.02636917,40.97363083,tract_part,http://www.prisonersofthecensus.org/data/2010blocks/400173007004099/
4.00E+14,68,25,0,0,0,5,9,107,122,229,46.72489083,53.27510917,tract_part,http://www.prisonersofthecensus.org/data/2010blocks/400173007003133/
4.00E+14,31,17,0,0,1,3,2,54,105,159,33.96226415,66.03773585,tract,http://www.prisonersofthecensus.org/data/2010blocks/400198929001076/
4.00E+14,19,13,0,0,0,4,1,37,54,91,40.65934066,59.34065934,tract_part,http://www.prisonersofthecensus.org/data/2010blocks/400198921001052/
4.00E+14,10,4,0,0,0,0,1,15,43,58,25.86206897,74.13793103,tract_part,http://www.prisonersofthecensus.org/data/2010blocks/400198923003056/
4.00E+14,4,40,0,0,2,9,14,69,29,98,70.40816327,29.59183673,tract_part,http://www.prisonersofthecensus.org/data/2010blocks/400219779004007/
4.00E+14,11,9,0,0,0,1,0,21,23,44,47.72727273,52.27272727,tract_part,http://www.prisonersofthecensus.org/data/2010blocks/400239671002070/
4.00E+14,0,0,0,0,0,0,2,2,2,4,50,50,tract_part,http://www.prisonersofthecensus.org/data/2010blocks/400259503002097/
4.00E+14,314,117,4,0,38,6,80,559,855,1414,39.53323904,60.46676096,institutionalized,http://www.prisonersofthecensus.org/data/2010blocks/400272024053018/
4.00E+14,365,156,13,0,56,54,103,747,843,1590,46.98113208,53.01886792,institutionalized,http://www.prisonersofthecensus.org/data/2010blocks/400272024053041/
4.00E+14,48,18,0,0,0,0,19,85,195,280,30.35714286,69.64285714,tract,http://www.prisonersofthecensus.org/data/2010blocks/400272001001029/
4.00E+14,29,1,3,2,3,4,21,63,96,159,39.62264151,60.37735849,tract_part,http://www.prisonersofthecensus.org/data/2010blocks/400310024042065/
4.00E+14,51,14,1,0,1,7,13,87,66,153,56.8627451,43.1372549,tract_part,http://www.prisonersofthecensus.org/data/2010blocks/400310019021148/
4.00E+14,27,21,0,0,3,5,9,65,19,84,77.38095238,22.61904762,institutionalized,http://www.prisonersofthecensus.org/data/2010blocks/400310025002004/
4.00E+14,83,49,1,0,2,18,19,172,127,299,57.52508361,42.47491639,institutionalized,http://www.prisonersofthecensus.org/data/2010blocks/400310025002119/
4.00E+14,885,267,3,6,48,78,179,1466,1096,2562,57.22092116,42.77907884,tract_part,http://www.prisonersofthecensus.org/data/2010blocks/400310020051071/
4.00E+14,7,8,0,0,0,0,4,19,26,45,42.22222222,57.77777778,tract_part,http://www.prisonersofthecensus.org/data/2010blocks/400353734002022/
4.00E+14,35,6,0,0,0,0,3,44,71,115,38.26086957,61.73913043,institutionalized,http://www.prisonersofthecensus.org/data/2010blocks/400353733003000/
4.00E+14,129,35,0,1,16,5,36,222,242,464,47.84482759,52.15517241,institutionalized,http://www.prisonersofthecensus.org/data/2010blocks/400353733003096/
4.00E+14,0,0,0,0,0,0,0,0,2,2,0,100,tract_part,http://www.prisonersofthecensus.org/data/2010blocks/400370209002084/
4.00E+14,0,1,0,0,0,0,1,2,13,15,13.33333333,86.66666667,tract_part,http://www.prisonersofthecensus.org/data/2010blocks/400370213001007/
4.00E+14,37,32,0,0,1,1,9,80,245,325,24.61538462,75.38461538,tract_part,http://www.prisonersofthecensus.org/data/2010blocks/400370201021097/
4.00E+14,15,25,0,0,0,0,25,65,57,122,53.27868852,46.72131148,tract_part,http://www.prisonersofthecensus.org/data/2010blocks/400399604006071/
4.00E+14,0,2,0,0,0,1,1,4,3,7,57.14285714,42.85714286,tract_part,http://www.prisonersofthecensus.org/data/2010blocks/400399606005025/
4.00E+14,1,20,0,0,1,0,1,23,40,63,36.50793651,63.49206349,tract_part,http://www.prisonersofthecensus.org/data/2010blocks/400413760005005/
4.00E+14,5,2,0,0,0,1,4,12,9,21,57.14285714,42.85714286,tract_part,http://www.prisonersofthecensus.org/data/2010blocks/400439593002106/
4.00E+14,0,0,0,0,0,0,1,1,4,5,20,80,tract_part,http://www.prisonersofthecensus.org/data/2010blocks/400459528001319/
4.00E+14,50,3,0,2,0,0,26,81,163,244,33.19672131,66.80327869,tract_part,http://www.prisonersofthecensus.org/data/2010blocks/400470006003008/
4.00E+14,16,12,0,0,0,0,6,34,63,97,35.05154639,64.94845361,tract_part,http://www.prisonersofthecensus.org/data/2010blocks/400470015005025/
4.00E+14,2,1,0,0,2,2,3,10,19,29,34.48275862,65.51724138,institutionalized,http://www.prisonersofthecensus.org/data/2010blocks/400496813001025/
4.00E+14,1,0,0,0,0,0,0,1,0,1,100,0,institutionalized,http://www.prisonersofthecensus.org/data/2010blocks/400496813001095/
4.00E+14,12,12,3,0,0,0,0,27,112,139,19.42446043,80.57553957,tract_part,http://www.prisonersofthecensus.org/data/2010blocks/400496814004104/
4.01E+14,17,2,0,0,0,0,0,19,56,75,25.33333333,74.66666667,institutionalized,http://www.prisonersofthecensus.org/data/2010blocks/400510010001000/
4.01E+14,97,14,0,0,0,1,1,113,402,515,21.94174757,78.05825243,institutionalized,http://www.prisonersofthecensus.org/data/2010blocks/400510010001002/
4.01E+14,0,2,0,0,1,1,2,6,11,17,35.29411765,64.70588235,tract_part,http://www.prisonersofthecensus.org/data/2010blocks/400539565003549/
4.01E+14,319,56,2,2,6,4,49,438,564,1002,43.71257485,56.28742515,tract_part,http://www.prisonersofthecensus.org/data/2010blocks/400559671001329/
4.01E+14,7,4,0,0,0,2,5,18,34,52,34.61538462,65.38461538,institutionalized,http://www.prisonersofthecensus.org/data/2010blocks/400559672004109/
4.01E+14,2,3,0,0,2,1,7,15,15,30,50,50,institutionalized,http://www.prisonersofthecensus.org/data/2010blocks/400559672004121/
4.01E+14,24,1,0,0,1,0,5,31,27,58,53.44827586,46.55172414,tract_part,http://www.prisonersofthecensus.org/data/2010blocks/400579678002208/
4.01E+14,1,1,0,0,0,0,0,2,2,4,50,50,tract_part,http://www.prisonersofthecensus.org/data/2010blocks/400599521001341/
4.01E+14,491,129,7,3,68,10,91,799,596,1395,57.27598566,42.72401434,tract_part,http://www.prisonersofthecensus.org/data/2010blocks/400634848001029/
4.01E+14,7,6,0,0,1,0,1,15,27,42,35.71428571,64.28571429,tract_part,http://www.prisonersofthecensus.org/data/2010blocks/400634849002053/
4.01E+14,22,4,0,0,3,1,11,41,51,92,44.56521739,55.43478261,institutionalized,http://www.prisonersofthecensus.org/data/2010blocks/400659687002027/
4.01E+14,37,2,0,0,0,0,21,60,52,112,53.57142857,46.42857143,institutionalized,http://www.prisonersofthecensus.org/data/2010blocks/400659687002137/
4.01E+14,1,0,0,0,0,0,3,4,9,13,30.76923077,69.23076923,institutionalized,http://www.prisonersofthecensus.org/data/2010blocks/400673718002153/
4.01E+14,13,6,0,0,0,0,3,22,36,58,37.93103448,62.06896552,institutionalized,http://www.prisonersofthecensus.org/data/2010blocks/400673718002177/
4.01E+14,2,5,0,0,0,0,2,9,40,49,18.36734694,81.63265306,tract_part,http://www.prisonersofthecensus.org/data/2010blocks/400696602005105/
4.01E+14,17,17,0,0,0,0,15,49,78,127,38.58267717,61.41732283,tract_part,http://www.prisonersofthecensus.org/data/2010blocks/400710012002191/
4.01E+14,0,4,0,0,1,0,1,6,8,14,42.85714286,57.14285714,tract_part,http://www.prisonersofthecensus.org/data/2010blocks/400710004002039/
4.01E+14,31,8,0,0,1,6,3,49,62,111,44.14414414,55.85585586,tract_part,http://www.prisonersofthecensus.org/data/2010blocks/400710005004002/
4.01E+14,0,1,0,0,0,0,0,1,0,1,100,0,tract_part,http://www.prisonersofthecensus.org/data/2010blocks/400710011003050/
4.01E+14,2,1,0,0,4,1,5,13,27,40,32.5,67.5,tract_part,http://www.prisonersofthecensus.org/data/2010blocks/400739583001130/
4.01E+14,2,1,0,0,0,0,3,6,12,18,33.33333333,66.66666667,institutionalized,http://www.prisonersofthecensus.org/data/2010blocks/400759637004038/
4.01E+14,23,4,0,0,1,0,4,32,51,83,38.55421687,61.44578313,institutionalized,http://www.prisonersofthecensus.org/data/2010blocks/400759637004040/
4.01E+14,1,3,0,0,0,0,1,5,21,26,19.23076923,80.76923077,tract_part,http://www.prisonersofthecensus.org/data/2010blocks/400770872004019/
4.01E+14,180,93,3,0,36,30,65,407,376,783,51.97956577,48.02043423,tract_part,http://www.prisonersofthecensus.org/data/2010blocks/400790406022140/
4.01E+14,17,7,0,0,8,0,15,47,92,139,33.81294964,66.18705036,tract_part,http://www.prisonersofthecensus.org/data/2010blocks/400790404022024/
4.01E+14,12,10,0,3,2,0,3,30,77,107,28.03738318,71.96261682,tract_part,http://www.prisonersofthecensus.org/data/2010blocks/400819617004065/
4.01E+14,0,0,0,0,0,1,0,1,4,5,20,80,tract_part,http://www.prisonersofthecensus.org/data/2010blocks/400850941001037/
4.01E+14,2,2,0,0,0,0,0,4,26,30,13.33333333,86.66666667,tract_part,http://www.prisonersofthecensus.org/data/2010blocks/400874003004023/
4.01E+14,0,0,0,0,0,0,0,0,1,1,0,100,tract_part,http://www.prisonersofthecensus.org/data/2010blocks/400890986005067/
4.01E+14,29,7,0,0,2,1,3,42,43,85,49.41176471,50.58823529,tract_part,http://www.prisonersofthecensus.org/data/2010blocks/400890987005031/
4.01E+14,27,14,0,0,0,0,6,47,73,120,39.16666667,60.83333333,institutionalized,http://www.prisonersofthecensus.org/data/2010blocks/400890988005010/
4.01E+14,2,1,0,0,0,0,0,3,1,4,75,25,institutionalized,http://www.prisonersofthecensus.org/data/2010blocks/400890988005054/
4.01E+14,9,15,1,0,0,0,4,29,51,80,36.25,63.75,tract_part,http://www.prisonersofthecensus.org/data/2010blocks/400917802003022/
4.01E+14,0,0,0,0,0,0,0,0,9,9,0,100,tract_part,http://www.prisonersofthecensus.org/data/2010blocks/400939553003088/
4.01E+14,1,1,0,0,0,0,6,8,34,42,19.04761905,80.95238095,tract_part,http://www.prisonersofthecensus.org/data/2010blocks/400950947001077/
4.01E+14,5,31,0,0,0,1,2,39,89,128,30.46875,69.53125,tract_part,http://www.prisonersofthecensus.org/data/2010blocks/400970401003011/
4.01E+14,2,5,0,0,0,2,2,11,34,45,24.44444444,75.55555556,tract_part,http://www.prisonersofthecensus.org/data/2010blocks/400997908004031/
4.01E+14,101,25,0,0,0,1,8,135,165,300,45,55,tract_part,http://www.prisonersofthecensus.org/data/2010blocks/401010004002079/
4.01E+14,152,109,2,1,14,30,46,354,459,813,43.54243542,56.45756458,institutionalized,http://www.prisonersofthecensus.org/data/2010blocks/401010012002034/
4.01E+14,244,88,2,3,29,6,53,425,613,1038,40.94412331,59.05587669,institutionalized,http://www.prisonersofthecensus.org/data/2010blocks/401010012002120/
4.01E+14,2,3,0,0,0,0,1,6,13,19,31.57894737,68.42105263,tract_part,http://www.prisonersofthecensus.org/data/2010blocks/401039570002044/
4.01E+14,11,2,0,0,0,0,3,16,33,49,32.65306122,67.34693878,tract_part,http://www.prisonersofthecensus.org/data/2010blocks/401051724003055/
4.01E+14,229,63,2,0,22,43,67,426,443,869,49.02186421,50.97813579,tract_part,http://www.prisonersofthecensus.org/data/2010blocks/401070807002135/
4.01E+14,3,10,0,0,0,0,0,13,10,23,56.52173913,43.47826087,tract_part,http://www.prisonersofthecensus.org/data/2010blocks/401070809002049/
4.01E+14,0,1,0,0,0,0,0,1,0,1,100,0,tract_part,http://www.prisonersofthecensus.org/data/2010blocks/401070810002163/
4.01E+14,0,2,0,0,0,0,0,2,2,4,50,50,tract,http://www.prisonersofthecensus.org/data/2010blocks/401091082073023/
4.01E+14,1,0,0,0,0,0,1,2,116,118,1.694915254,98.30508475,tract,http://www.prisonersofthecensus.org/data/2010blocks/401091082191049/
4.01E+14,0,0,0,0,0,0,0,0,3,3,0,100,tract_part,http://www.prisonersofthecensus.org/data/2010blocks/401091085122021/
4.01E+14,1,0,0,0,0,0,0,1,1,2,50,50,tract,http://www.prisonersofthecensus.org/data/2010blocks/401091078044006/
4.01E+14,15,1,0,0,0,0,0,16,9,25,64,36,tract,http://www.prisonersofthecensus.org/data/2010blocks/401091080082009/
4.01E+14,2,0,0,0,2,0,2,6,6,12,50,50,tract,http://www.prisonersofthecensus.org/data/2010blocks/401091012002009/
4.01E+14,906,83,6,0,188,23,268,1474,813,2287,64.45124617,35.54875383,institutionalized,http://www.prisonersofthecensus.org/data/2010blocks/401091032001039/
4.01E+14,39,7,0,0,2,0,3,51,49,100,51,49,institutionalized,http://www.prisonersofthecensus.org/data/2010blocks/401091032002002/
4.01E+14,9,2,0,0,3,0,3,17,26,43,39.53488372,60.46511628,institutionalized,http://www.prisonersofthecensus.org/data/2010blocks/401091032002003/
4.01E+14,46,16,0,0,1,5,4,72,75,147,48.97959184,51.02040816,tract,http://www.prisonersofthecensus.org/data/2010blocks/401091037001006/
4.01E+14,75,17,1,0,0,4,7,104,121,225,46.22222222,53.77777778,tract,http://www.prisonersofthecensus.org/data/2010blocks/401091051002007/
4.01E+14,89,26,2,0,5,0,31,153,131,284,53.87323944,46.12676056,tract_part,http://www.prisonersofthecensus.org/data/2010blocks/401091057001015/
4.01E+14,43,24,0,0,0,1,1,69,86,155,44.51612903,55.48387097,tract,http://www.prisonersofthecensus.org/data/2010blocks/401091059041002/
4.01E+14,51,43,1,0,2,10,18,125,143,268,46.64179104,53.35820896,tract,http://www.prisonersofthecensus.org/data/2010blocks/401091061002032/
4.01E+14,32,19,1,0,8,5,11,76,114,190,40,60,tract,http://www.prisonersofthecensus.org/data/2010blocks/401091073061013/
4.01E+14,108,12,0,0,13,0,19,152,131,283,53.71024735,46.28975265,tract_part,http://www.prisonersofthecensus.org/data/2010blocks/401091081102031/
4.01E+14,1,0,0,0,0,0,0,1,0,1,100,0,tract_part,http://www.prisonersofthecensus.org/data/2010blocks/401110006001037/
4.01E+14,0,5,0,0,0,1,0,6,2,8,75,25,tract_part,http://www.prisonersofthecensus.org/data/2010blocks/401110009024188/
4.01E+14,33,36,0,0,0,1,1,71,139,210,33.80952381,66.19047619,tract_part,http://www.prisonersofthecensus.org/data/2010blocks/401110003003045/
4.01E+14,452,95,8,0,7,2,57,621,570,1191,52.14105793,47.85894207,tract_part,http://www.prisonersofthecensus.org/data/2010blocks/401139400012211/
4.01E+14,16,22,0,0,0,0,3,41,67,108,37.96296296,62.03703704,tract_part,http://www.prisonersofthecensus.org/data/2010blocks/401139400023059/
4.01E+14,10,23,0,2,0,1,9,45,94,139,32.37410072,67.62589928,tract_part,http://www.prisonersofthecensus.org/data/2010blocks/401155745001071/
4.01E+14,4,14,0,0,0,0,0,18,24,42,42.85714286,57.14285714,tract_part,http://www.prisonersofthecensus.org/data/2010blocks/401179575001079/
4.01E+14,235,58,1,1,27,29,64,415,283,698,59.45558739,40.54441261,tract_part,http://www.prisonersofthecensus.org/data/2010blocks/401190114004086/
4.01E+14,32,20,1,0,7,19,12,91,101,192,47.39583333,52.60416667,tract_part,http://www.prisonersofthecensus.org/data/2010blocks/401190107001009/
4.01E+14,3,0,0,0,0,3,3,9,34,43,20.93023256,79.06976744,tract_part,http://www.prisonersofthecensus.org/data/2010blocks/401190110004027/
4.01E+14,7,20,0,0,3,7,6,43,63,106,40.56603774,59.43396226,tract_part,http://www.prisonersofthecensus.org/data/2010blocks/401214862002023/
4.01E+14,293,138,1,0,43,32,137,644,420,1064,60.52631579,39.47368421,institutionalized,http://www.prisonersofthecensus.org/data/2010blocks/401214863001007/
4.01E+14,229,81,1,2,42,27,67,449,375,824,54.49029126,45.50970874,institutionalized,http://www.prisonersofthecensus.org/data/2010blocks/401214863001061/
4.01E+14,8,26,0,0,2,0,13,49,43,92,53.26086957,46.73913043,tract,http://www.prisonersofthecensus.org/data/2010blocks/401230892001078/
4.01E+14,217,149,4,0,22,84,74,550,535,1085,50.69124424,49.30875576,tract_part,http://www.prisonersofthecensus.org/data/2010blocks/401255010013042/
4.01E+14,56,5,0,0,5,0,8,74,140,214,34.57943925,65.42056075,tract_part,http://www.prisonersofthecensus.org/data/2010blocks/401255005002035/
4.01E+14,0,3,0,0,0,0,0,3,10,13,23.07692308,76.92307692,tract_part,http://www.prisonersofthecensus.org/data/2010blocks/401270977003048/
4.01E+14,4,0,0,0,0,0,0,4,7,11,36.36363636,63.63636364,tract_part,http://www.prisonersofthecensus.org/data/2010blocks/401299600003179/
4.01E+14,19,18,0,1,2,1,9,50,143,193,25.90673575,74.09326425,tract_part,http://www.prisonersofthecensus.org/data/2010blocks/401310501011050/
4.01E+14,0,4,0,0,0,0,0,4,0,4,100,0,tract_part,http://www.prisonersofthecensus.org/data/2010blocks/401335835001030/
4.01E+14,4,23,0,0,0,0,0,27,47,74,36.48648649,63.51351351,tract_part,http://www.prisonersofthecensus.org/data/2010blocks/401335836004012/
4.01E+14,16,24,0,1,0,0,2,43,68,111,38.73873874,61.26126126,tract_part,http://www.prisonersofthecensus.org/data/2010blocks/401350303027064/
4.01E+14,23,5,0,0,0,0,6,34,108,142,23.94366197,76.05633803,tract,http://www.prisonersofthecensus.org/data/2010blocks/401370003002062/
4.01E+14,9,1,0,0,12,0,26,48,21,69,69.56521739,30.43478261,tract_part,http://www.prisonersofthecensus.org/data/2010blocks/401399509005045/
4.01E+14,26,8,0,0,5,1,19,59,33,92,64.13043478,35.86956522,tract_part,http://www.prisonersofthecensus.org/data/2010blocks/401410704003094/
4.01E+14,44,6,0,0,0,6,7,63,51,114,55.26315789,44.73684211,tract_part,http://www.prisonersofthecensus.org/data/2010blocks/401410701002305/
4.01E+14,515,55,9,1,21,2,233,836,783,1619,51.63681285,48.36318715,institutionalized,http://www.prisonersofthecensus.org/data/2010blocks/401430025002058/
4.01E+14,86,25,0,0,1,14,7,133,114,247,53.84615385,46.15384615,institutionalized,http://www.prisonersofthecensus.org/data/2010blocks/401430025002166/
4.01E+14,56,11,0,0,0,0,12,79,53,132,59.84848485,40.15151515,tract_part,http://www.prisonersofthecensus.org/data/2010blocks/401430027001037/
4.01E+14,9,4,1,0,1,7,1,23,66,89,25.84269663,74.15730337,tract,http://www.prisonersofthecensus.org/data/2010blocks/401430076082004/
4.01E+14,42,20,0,0,2,5,3,72,68,140,51.42857143,48.57142857,tract_part,http://www.prisonersofthecensus.org/data/2010blocks/401430091012019/
4.01E+14,17,1,0,0,0,0,1,19,61,80,23.75,76.25,tract_part,http://www.prisonersofthecensus.org/data/2010blocks/401450301012122/
4.01E+14,10,16,0,0,0,6,5,37,67,104,35.57692308,64.42307692,tract_part,http://www.prisonersofthecensus.org/data/2010blocks/401470003003015/
4.02E+14,0,3,0,0,2,2,5,12,23,35,34.28571429,65.71428571,tract_part,http://www.prisonersofthecensus.org/data/2010blocks/401499651001237/
4.02E+14,0,1,0,0,0,0,2,3,6,9,33.33333333,66.66666667,tract_part,http://www.prisonersofthecensus.org/data/2010blocks/401519543002029/
4.02E+14,179,55,1,1,18,11,46,311,291,602,51.66112957,48.33887043,tract_part,http://www.prisonersofthecensus.org/data/2010blocks/401519543003001/
4.02E+14,1,0,0,0,0,0,0,1,3,4,25,75,tract_part,http://www.prisonersofthecensus.org/data/2010blocks/401539533003059/
4.02E+14,3,2,0,0,0,0,3,8,47,55,14.54545455,85.45454545,tract_part,http://www.prisonersofthecensus.org/data/2010blocks/401539534002031/
4.02E+14,250,98,5,2,20,33,86,494,567,1061,46.5598492,53.4401508,tract_part,http://www.prisonersofthecensus.org/data/2010blocks/401539532001019/
4.10E+14,21,5,4,0,2,2,10,44,230,274,16.05839416,83.94160584,tract_part,http://www.prisonersofthecensus.org/data/2010blocks/410019505002000/
4.10E+14,0,0,0,0,0,0,2,2,33,35,5.714285714,94.28571429,institutionalized,http://www.prisonersofthecensus.org/data/2010blocks/410030106001031/
4.10E+14,1,0,1,0,0,0,1,3,4,7,42.85714286,57.14285714,institutionalized,http://www.prisonersofthecensus.org/data/2010blocks/410030106001032/
4.10E+14,19,4,7,0,48,2,56,136,311,447,30.42505593,69.57494407,tract_part,http://www.prisonersofthecensus.org/data/2010blocks/410050226051014/
4.10E+14,2,0,0,0,0,0,2,4,64,68,5.882352941,94.11764706,tract_part,http://www.prisonersofthecensus.org/data/2010blocks/410079502003004/
4.10E+14,4,8,4,0,21,17,48,102,119,221,46.15384615,53.84615385,tract_part,http://www.prisonersofthecensus.org/data/2010blocks/410099708002004/
4.10E+14,0,0,0,0,0,2,1,3,11,14,21.42857143,78.57142857,tract_part,http://www.prisonersofthecensus.org/data/2010blocks/410110010006026/
4.10E+14,2,0,0,0,1,1,5,9,73,82,10.97560976,89.02439024,tract_part,http://www.prisonersofthecensus.org/data/2010blocks/410110009005031/
4.10E+14,12,4,3,1,7,0,12,39,189,228,17.10526316,82.89473684,tract_part,http://www.prisonersofthecensus.org/data/2010blocks/410110001003117/
4.10E+14,0,0,0,0,0,0,2,2,14,16,12.5,87.5,tract_part,http://www.prisonersofthecensus.org/data/2010blocks/410139503001022/
4.10E+14,1,0,0,0,0,0,0,1,26,27,3.703703704,96.2962963,tract_part,http://www.prisonersofthecensus.org/data/2010blocks/410159502001169/
4.10E+14,0,0,0,0,1,0,2,3,20,23,13.04347826,86.95652174,institutionalized,http://www.prisonersofthecensus.org/data/2010blocks/410170011001067/
4.10E+14,3,15,0,0,3,11,21,53,132,185,28.64864865,71.35135135,institutionalized,http://www.prisonersofthecensus.org/data/2010blocks/410170011001068/
4.10E+14,0,1,0,0,1,0,1,3,8,11,27.27272727,72.72727273,tract_part,http://www.prisonersofthecensus.org/data/2010blocks/410191800004026/
4.10E+14,2,1,0,0,2,0,8,13,197,210,6.19047619,93.80952381,tract_part,http://www.prisonersofthecensus.org/data/2010blocks/410191300002015/
4.10E+14,0,0,0,0,0,0,1,1,8,9,11.11111111,88.88888889,tract_part,http://www.prisonersofthecensus.org/data/2010blocks/410239602003068/
4.10E+14,0,5,0,0,0,0,2,7,10,17,41.17647059,58.82352941,tract_part,http://www.prisonersofthecensus.org/data/2010blocks/410259601001788/
4.10E+14,10,3,0,0,4,0,32,49,125,174,28.16091954,71.83908046,tract_part,http://www.prisonersofthecensus.org/data/2010blocks/410290017001012/
4.10E+14,11,0,0,1,21,1,45,79,153,232,34.05172414,65.94827586,tract,http://www.prisonersofthecensus.org/data/2010blocks/410290002013025/
4.10E+14,0,0,0,0,0,0,0,0,4,4,0,100,tract_part,http://www.prisonersofthecensus.org/data/2010blocks/410290016011042/
4.10E+14,42,23,9,0,6,3,23,106,546,652,16.25766871,83.74233129,tract_part,http://www.prisonersofthecensus.org/data/2010blocks/410319601001491/
4.10E+14,1,18,1,0,0,1,16,37,36,73,50.68493151,49.31506849,tract_part,http://www.prisonersofthecensus.org/data/2010blocks/410319601002181/
4.10E+14,0,42,0,0,0,0,0,42,0,42,100,0,tract_part,http://www.prisonersofthecensus.org/data/2010blocks/410319400001208/
4.10E+14,2,0,2,0,0,0,18,22,119,141,15.60283688,84.39716312,tract_part,http://www.prisonersofthecensus.org/data/2010blocks/410333605004049/
4.10E+14,0,0,0,0,0,0,1,1,9,10,10,90,tract_part,http://www.prisonersofthecensus.org/data/2010blocks/410333601001082/
4.10E+14,1,13,0,0,0,0,8,22,55,77,28.57142857,71.42857143,tract_part,http://www.prisonersofthecensus.org/data/2010blocks/410359711001012/
4.10E+14,0,0,0,0,0,0,0,0,13,13,0,100,tract_part,http://www.prisonersofthecensus.org/data/2010blocks/410379602004021/
4.10E+14,26,8,5,0,6,3,17,65,339,404,16.08910891,83.91089109,tract_part,http://www.prisonersofthecensus.org/data/2010blocks/410379602001612/
4.10E+14,0,0,0,0,0,0,0,0,3,3,0,100,tract_part,http://www.prisonersofthecensus.org/data/2010blocks/410390012013030/
4.10E+14,26,13,1,4,58,38,86,226,290,516,43.79844961,56.20155039,tract,http://www.prisonersofthecensus.org/data/2010blocks/410390039001002/
4.10E+14,0,1,0,0,0,2,0,3,1,4,75,25,tract,http://www.prisonersofthecensus.org/data/2010blocks/410390044013010/
4.10E+14,0,2,0,0,0,0,2,4,17,21,19.04761905,80.95238095,tract,http://www.prisonersofthecensus.org/data/2010blocks/410390045011020/
4.10E+14,3,2,0,0,2,3,4,14,30,44,31.81818182,68.18181818,tract,http://www.prisonersofthecensus.org/data/2010blocks/410390033023009/
4.10E+14,0,0,0,0,0,0,0,0,14,14,0,100,tract_part,http://www.prisonersofthecensus.org/data/2010blocks/410390036001051/
4.10E+14,0,0,0,0,0,0,0,0,1,1,0,100,tract_part,http://www.prisonersofthecensus.org/data/2010blocks/410390007073055/
4.10E+14,1,0,6,0,0,0,0,7,22,29,24.13793103,75.86206897,tract_part,http://www.prisonersofthecensus.org/data/2010blocks/410419509002003/
4.10E+14,0,6,2,1,2,9,10,30,120,150,20,80,tract_part,http://www.prisonersofthecensus.org/data/2010blocks/410419510002032/
4.10E+14,4,2,2,0,0,1,11,20,194,214,9.345794393,90.65420561,tract,http://www.prisonersofthecensus.org/data/2010blocks/410430208011005/
4.10E+14,255,59,39,1,112,15,584,1065,1992,3057,34.83807655,65.16192345,tract_part,http://www.prisonersofthecensus.org/data/2010blocks/410459709003967/
4.10E+14,2,1,0,0,9,0,39,51,44,95,53.68421053,46.31578947,tract_part,http://www.prisonersofthecensus.org/data/2010blocks/410459706002360/
4.10E+14,1,0,0,0,5,1,6,13,2,15,86.66666667,13.33333333,tract_part,http://www.prisonersofthecensus.org/data/2010blocks/410470018014004/
4.10E+14,17,2,0,0,0,1,5,25,154,179,13.96648045,86.03351955,remaining,http://www.prisonersofthecensus.org/data/2010blocks/410470007013000/
4.10E+14,279,69,30,0,113,11,240,742,1470,2212,33.5443038,66.4556962,institutionalized,http://www.prisonersofthecensus.org/data/2010blocks/410470007013009/
4.10E+14,0,1,0,0,0,0,1,2,4,6,33.33333333,66.66666667,tract_part,http://www.prisonersofthecensus.org/data/2010blocks/410470016012007/
4.10E+14,22,32,3,6,77,36,186,362,340,702,51.56695157,48.43304843,institutionalized,http://www.prisonersofthecensus.org/data/2010blocks/410470018032001/
4.10E+14,109,19,13,2,36,7,96,282,648,930,30.32258065,69.67741935,institutionalized,http://www.prisonersofthecensus.org/data/2010blocks/410470018032004/
4.10E+14,42,11,7,0,13,1,29,103,340,443,23.25056433,76.74943567,institutionalized,http://www.prisonersofthecensus.org/data/2010blocks/410470018032009/
4.10E+14,20,4,2,0,4,2,15,47,196,243,19.34156379,80.65843621,institutionalized,http://www.prisonersofthecensus.org/data/2010blocks/410470018032041/
4.11E+14,0,0,1,0,0,1,0,2,1,3,66.66666667,33.33333333,tract,http://www.prisonersofthecensus.org/data/2010blocks/410510100021016/
4.11E+14,0,0,0,0,0,0,0,0,5,5,0,100,tract,http://www.prisonersofthecensus.org/data/2010blocks/410510006022017/
4.11E+14,0,0,0,0,0,0,0,0,1,1,0,100,tract,http://www.prisonersofthecensus.org/data/2010blocks/410510021001085/
4.11E+14,5,0,0,2,0,3,7,17,5,22,77.27272727,22.72727273,tract,http://www.prisonersofthecensus.org/data/2010blocks/410510035011027/
4.11E+14,104,13,9,0,2,0,13,141,422,563,25.04440497,74.95559503,institutionalized,http://www.prisonersofthecensus.org/data/2010blocks/410510073001006/
4.11E+14,240,25,23,0,21,6,160,475,403,878,54.10022779,45.89977221,institutionalized,http://www.prisonersofthecensus.org/data/2010blocks/410510073001199/
4.11E+14,17,7,1,0,4,0,118,147,19,166,88.55421687,11.44578313,tract,http://www.prisonersofthecensus.org/data/2010blocks/410510093021011/
4.11E+14,4,8,5,1,0,4,1,23,20,43,53.48837209,46.51162791,tract,http://www.prisonersofthecensus.org/data/2010blocks/410510048001007/
4.11E+14,10,0,0,0,0,1,0,11,15,26,42.30769231,57.69230769,institutionalized,http://www.prisonersofthecensus.org/data/2010blocks/410510051002056/
4.11E+14,11,2,0,1,5,0,4,23,42,65,35.38461538,64.61538462,institutionalized,http://www.prisonersofthecensus.org/data/2010blocks/410510051002062/
4.11E+14,8,2,0,0,0,0,2,12,42,54,22.22222222,77.77777778,institutionalized,http://www.prisonersofthecensus.org/data/2010blocks/410510051003011/
4.11E+14,93,3,7,0,11,1,53,168,229,397,42.31738035,57.68261965,tract,http://www.prisonersofthecensus.org/data/2010blocks/410510106003059/
4.11E+14,1,2,1,0,0,0,11,15,103,118,12.71186441,87.28813559,tract,http://www.prisonersofthecensus.org/data/2010blocks/410530202031013/
4.11E+14,15,6,4,0,7,1,16,49,156,205,23.90243902,76.09756098,institutionalized,http://www.prisonersofthecensus.org/data/2010blocks/410579604006050/
4.11E+14,1,3,0,0,1,3,8,16,56,72,22.22222222,77.77777778,institutionalized,http://www.prisonersofthecensus.org/data/2010blocks/410579604007128/
4.11E+14,135,45,23,1,65,9,339,617,1209,1826,33.78970427,66.21029573,tract_part,http://www.prisonersofthecensus.org/data/2010blocks/410599508001021/
4.11E+14,139,45,23,0,61,9,335,612,1069,1681,36.40690065,63.59309935,tract_part,http://www.prisonersofthecensus.org/data/2010blocks/410599504002161/
4.11E+14,0,1,0,0,0,0,0,1,14,15,6.666666667,93.33333333,tract_part,http://www.prisonersofthecensus.org/data/2010blocks/410599505003002/
4.11E+14,0,0,0,0,0,0,0,0,5,5,0,100,tract,http://www.prisonersofthecensus.org/data/2010blocks/410619707002013/
4.11E+14,4,7,1,0,4,6,14,36,78,114,31.57894737,68.42105263,tract_part,http://www.prisonersofthecensus.org/data/2010blocks/410659705003050/
4.11E+14,11,4,1,0,10,12,30,68,141,209,32.53588517,67.46411483,institutionalized,http://www.prisonersofthecensus.org/data/2010blocks/410670325011004/
4.11E+14,34,6,7,0,10,24,134,215,371,586,36.6894198,63.3105802,institutionalized,http://www.prisonersofthecensus.org/data/2010blocks/410670325011005/
4.11E+14,6,0,0,0,0,0,0,6,0,6,100,0,tract_part,http://www.prisonersofthecensus.org/data/2010blocks/410670319112011/
4.11E+14,123,49,18,0,23,8,83,304,1274,1578,19.26489227,80.73510773,tract_part,http://www.prisonersofthecensus.org/data/2010blocks/410670321101020/
4.11E+14,0,0,0,0,0,2,2,4,12,16,25,75,tract_part,http://www.prisonersofthecensus.org/data/2010blocks/410670314032018/
4.11E+14,0,0,1,0,0,1,0,2,1,3,66.66666667,33.33333333,tract_part,http://www.prisonersofthecensus.org/data/2010blocks/410670316104015/
4.11E+14,7,8,1,1,7,12,19,55,150,205,26.82926829,73.17073171,tract,http://www.prisonersofthecensus.org/data/2010blocks/410710308012078/
4.11E+14,0,0,1,0,1,1,1,4,13,17,23.52941176,76.47058824,tract_part,http://www.prisonersofthecensus.org/data/2010blocks/410710308022000/
4.11E+14,38,11,40,10,55,36,113,303,208,511,59.29549902,40.70450098,institutionalized,http://www.prisonersofthecensus.org/data/2010blocks/410710305014005/
4.11E+14,264,79,34,29,274,57,530,1267,412,1679,75.46158428,24.53841572,institutionalized,http://www.prisonersofthecensus.org/data/2010blocks/410710305014010/
4.20E+14,50,0,0,0,9,1,20,80,236,316,25.3164557,74.6835443,tract_part,http://www.prisonersofthecensus.org/data/2010blocks/420010306001065/
4.20E+14,72,1,0,0,2,0,4,79,32,111,71.17117117,28.82882883,tract,http://www.prisonersofthecensus.org/data/2010blocks/420035138002038/
4.20E+14,0,0,0,0,0,0,0,0,1,1,0,100,tract,http://www.prisonersofthecensus.org/data/2010blocks/420035235011012/
4.20E+14,1587,1,1,1,4,4,52,1650,986,2636,62.59484067,37.40515933,tract,http://www.prisonersofthecensus.org/data/2010blocks/420030103001007/
4.20E+14,22,0,0,0,0,0,0,22,25,47,46.80851064,53.19148936,tract,http://www.prisonersofthecensus.org/data/2010blocks/420030409001003/
4.20E+14,6,0,0,0,0,0,0,6,24,30,20,80,tract,http://www.prisonersofthecensus.org/data/2010blocks/420030709001000/
4.20E+14,4,0,0,0,0,0,0,4,6,10,40,60,tract,http://www.prisonersofthecensus.org/data/2010blocks/420031807003015/
4.20E+14,815,0,3,0,136,2,131,1087,840,1927,56.40892579,43.59107421,tract,http://www.prisonersofthecensus.org/data/2010blocks/420039809001009/
4.20E+14,20,0,0,0,6,0,6,32,133,165,19.39393939,80.60606061,tract_part,http://www.prisonersofthecensus.org/data/2010blocks/420059506002052/
4.20E+14,6,0,0,0,0,0,0,6,9,15,40,60,tract,http://www.prisonersofthecensus.org/data/2010blocks/420076045001005/
4.20E+14,116,0,0,0,5,1,4,126,139,265,47.54716981,52.45283019,tract,http://www.prisonersofthecensus.org/data/2010blocks/420076049011001/
4.20E+14,24,1,0,0,1,1,1,28,36,64,43.75,56.25,tract,http://www.prisonersofthecensus.org/data/2010blocks/420076014002019/
4.20E+14,37,0,0,0,41,2,42,122,101,223,54.70852018,45.29147982,tract,http://www.prisonersofthecensus.org/data/2010blocks/420099608001132/
4.20E+14,281,1,2,0,0,1,374,659,431,1090,60.4587156,39.5412844,tract_part,http://www.prisonersofthecensus.org/data/2010blocks/420110103044028/
4.20E+14,0,0,0,0,0,0,0,0,15,15,0,100,tract_part,http://www.prisonersofthecensus.org/data/2010blocks/420110130001002/
4.20E+14,11,1,0,0,22,2,27,63,28,91,69.23076923,30.76923077,institutionalized,http://www.prisonersofthecensus.org/data/2010blocks/420110001004003/
4.20E+14,0,0,0,0,0,2,2,4,2,6,66.66666667,33.33333333,institutionalized,http://www.prisonersofthecensus.org/data/2010blocks/420110001004018/
4.20E+14,21,3,0,0,23,5,33,85,45,130,65.38461538,34.61538462,tract,http://www.prisonersofthecensus.org/data/2010blocks/420110013003005/
4.20E+14,0,0,0,0,0,0,0,0,6,6,0,100,institutionalized,http://www.prisonersofthecensus.org/data/2010blocks/420130112003028/
4.20E+14,47,0,1,0,0,4,0,52,223,275,18.90909091,81.09090909,institutionalized,http://www.prisonersofthecensus.org/data/2010blocks/420130112004031/
4.20E+14,1,1,0,0,0,3,0,5,81,86,5.813953488,94.18604651,tract_part,http://www.prisonersofthecensus.org/data/2010blocks/420159513001180/
4.20E+14,8,0,1,0,0,0,0,9,1,10,90,10,tract,http://www.prisonersofthecensus.org/data/2010blocks/420171002091000/
4.20E+14,2,0,0,0,0,0,0,2,7,9,22.22222222,77.77777778,tract_part,http://www.prisonersofthecensus.org/data/2010blocks/420171004021001/
4.20E+14,208,8,5,0,20,33,85,359,705,1064,33.7406015,66.2593985,tract,http://www.prisonersofthecensus.org/data/2010blocks/420171046033018/
4.20E+14,13,3,0,0,1,5,7,29,179,208,13.94230769,86.05769231,tract,http://www.prisonersofthecensus.org/data/2010blocks/420199023003026/
4.20E+14,440,19,15,1,93,43,234,845,292,1137,74.31838171,25.68161829,tract_part,http://www.prisonersofthecensus.org/data/2010blocks/420210123001054/
4.20E+14,162,0,1,0,5,1,35,204,238,442,46.15384615,53.84615385,tract_part,http://www.prisonersofthecensus.org/data/2010blocks/420210125001054/
4.20E+14,574,0,2,0,160,0,160,896,732,1628,55.03685504,44.96314496,tract_part,http://www.prisonersofthecensus.org/data/2010blocks/420210128002003/
4.20E+14,15,0,0,0,2,0,2,19,33,52,36.53846154,63.46153846,tract,http://www.prisonersofthecensus.org/data/2010blocks/420210001002014/
4.20E+14,13,1,0,0,2,1,9,26,135,161,16.14906832,83.85093168,tract_part,http://www.prisonersofthecensus.org/data/2010blocks/420250203001001/
4.20E+14,29,2,4,0,5,5,16,61,216,277,22.02166065,77.97833935,institutionalized,http://www.prisonersofthecensus.org/data/2010blocks/420270112012073/
4.20E+14,27,0,0,0,9,0,9,45,31,76,59.21052632,40.78947368,institutionalized,http://www.prisonersofthecensus.org/data/2010blocks/420270112012145/
4.20E+14,926,0,4,0,205,2,205,1342,860,2202,60.94459582,39.05540418,tract_part,http://www.prisonersofthecensus.org/data/2010blocks/420279812021002/
4.20E+14,0,0,0,0,0,0,0,0,14,14,0,100,tract,http://www.prisonersofthecensus.org/data/2010blocks/420270120004005/
4.20E+14,310,8,5,1,58,36,140,558,428,986,56.59229209,43.40770791,tract,http://www.prisonersofthecensus.org/data/2010blocks/420293113002041/
4.20E+14,1,1,0,0,2,1,4,9,76,85,10.58823529,89.41176471,tract_part,http://www.prisonersofthecensus.org/data/2010blocks/420311603001066/
4.20E+14,320,24,86,0,281,193,1120,2024,82,2106,96.10636277,3.893637227,tract_part,http://www.prisonersofthecensus.org/data/2010blocks/420333309002000/
4.20E+14,148,0,0,0,58,1,58,265,168,433,61.20092379,38.79907621,tract_part,http://www.prisonersofthecensus.org/data/2010blocks/420333307002024/
4.20E+14,2,0,0,0,0,5,3,10,127,137,7.299270073,92.70072993,tract_part,http://www.prisonersofthecensus.org/data/2010blocks/420333306002113/
4.20E+14,1137,0,6,0,217,3,240,1603,852,2455,65.29531568,34.70468432,tract_part,http://www.prisonersofthecensus.org/data/2010blocks/420333317003061/
4.20E+14,113,0,6,3,54,0,53,229,149,378,60.58201058,39.41798942,tract_part,http://www.prisonersofthecensus.org/data/2010blocks/420350305002068/
4.20E+14,28,1,4,0,2,8,17,60,139,199,30.15075377,69.84924623,tract,http://www.prisonersofthecensus.org/data/2010blocks/420370510002001/
4.20E+14,322,2,2,2,23,1,69,421,598,1019,41.31501472,58.68498528,tract_part,http://www.prisonersofthecensus.org/data/2010blocks/420391102023034/
4.20E+14,23,0,0,0,3,0,3,29,177,206,14.0776699,85.9223301,tract_part,http://www.prisonersofthecensus.org/data/2010blocks/420391107003002/
4.20E+14,1477,1,10,0,471,10,477,2446,1464,3910,62.55754476,37.44245524,tract,http://www.prisonersofthecensus.org/data/2010blocks/420419810011001/
4.20E+14,65,0,3,0,1,1,18,88,324,412,21.3592233,78.6407767,tract_part,http://www.prisonersofthecensus.org/data/2010blocks/420410118032165/
4.20E+14,40,0,0,0,0,0,9,49,49,98,50,50,tract,http://www.prisonersofthecensus.org/data/2010blocks/420430205001015/
4.20E+14,14,0,0,0,1,0,6,21,30,51,41.17647059,58.82352941,tract,http://www.prisonersofthecensus.org/data/2010blocks/420430212002046/
4.20E+14,551,0,1,0,13,5,78,648,308,956,67.78242678,32.21757322,institutionalized,http://www.prisonersofthecensus.org/data/2010blocks/420430229002051/
4.20E+14,95,0,0,0,4,1,9,109,90,199,54.77386935,45.22613065,remaining,http://www.prisonersofthecensus.org/data/2010blocks/420430229002058/
4.20E+14,55,0,0,0,4,1,13,73,49,122,59.83606557,40.16393443,tract_part,http://www.prisonersofthecensus.org/data/2010blocks/420430246005019/
4.20E+14,538,0,5,0,220,7,227,997,413,1410,70.70921986,29.29078014,tract,http://www.prisonersofthecensus.org/data/2010blocks/420454107001017/
4.20E+14,885,0,6,0,47,1,48,987,650,1637,60.2932193,39.7067807,tract,http://www.prisonersofthecensus.org/data/2010blocks/420454103012008/
4.20E+14,1,0,0,0,0,1,0,2,49,51,3.921568627,96.07843137,tract,http://www.prisonersofthecensus.org/data/2010blocks/420479504002011/
4.21E+14,1043,1,7,0,173,0,197,1421,951,2372,59.90725126,40.09274874,tract,http://www.prisonersofthecensus.org/data/2010blocks/420499801091000/
4.20E+14,28,0,1,0,3,0,10,42,55,97,43.29896907,56.70103093,institutionalized,http://www.prisonersofthecensus.org/data/2010blocks/420490003002011/
4.20E+14,7,0,0,0,0,1,0,8,24,32,25,75,institutionalized,http://www.prisonersofthecensus.org/data/2010blocks/420490003002033/
4.20E+14,231,0,0,0,42,2,69,344,322,666,51.65165165,48.34834835,tract,http://www.prisonersofthecensus.org/data/2010blocks/420490014002007/
4.20E+14,0,0,0,0,0,0,0,0,3,3,0,100,tract,http://www.prisonersofthecensus.org/data/2010blocks/420490019001008/
4.21E+14,1113,0,7,1,201,1,200,1523,607,2130,71.50234742,28.49765258,tract_part,http://www.prisonersofthecensus.org/data/2010blocks/420512613004068/
4.21E+14,55,1,0,1,0,3,4,64,194,258,24.80620155,75.19379845,tract,http://www.prisonersofthecensus.org/data/2010blocks/420512619003031/
4.21E+14,1229,0,6,0,304,2,299,1840,638,2478,74.25343019,25.74656981,tract_part,http://www.prisonersofthecensus.org/data/2010blocks/420535301004044/
4.21E+14,6,0,0,0,0,0,10,16,1,17,94.11764706,5.882352941,tract_part,http://www.prisonersofthecensus.org/data/2010blocks/420550104002034/
4.21E+14,1032,0,10,0,200,1,200,1443,576,2019,71.47102526,28.52897474,institutionalized,http://www.prisonersofthecensus.org/data/2010blocks/420599705011024/
4.21E+14,3,0,0,0,0,0,0,3,84,87,3.448275862,96.55172414,institutionalized,http://www.prisonersofthecensus.org/data/2010blocks/420599705011046/
4.21E+14,11,0,0,0,0,0,0,11,43,54,20.37037037,79.62962963,tract,http://www.prisonersofthecensus.org/data/2010blocks/420619504004016/
4.21E+14,1174,2,10,0,222,1,226,1635,574,2209,74.01539158,25.98460842,institutionalized,http://www.prisonersofthecensus.org/data/2010blocks/420619503004004/
4.21E+14,715,0,4,0,116,0,116,951,350,1301,73.09761722,26.90238278,institutionalized,http://www.prisonersofthecensus.org/data/2010blocks/420619503005000/
4.21E+14,622,0,3,0,86,3,94,808,284,1092,73.99267399,26.00732601,tract_part,http://www.prisonersofthecensus.org/data/2010blocks/420639609002016/
4.21E+14,4,1,0,0,0,1,3,9,87,96,9.375,90.625,tract_part,http://www.prisonersofthecensus.org/data/2010blocks/420659506001035/
4.21E+14,0,0,0,0,0,0,4,4,35,39,10.25641026,89.74358974,tract_part,http://www.prisonersofthecensus.org/data/2010blocks/420670701005028/
4.21E+14,31,0,0,0,0,0,4,35,23,58,60.34482759,39.65517241,institutionalized,http://www.prisonersofthecensus.org/data/2010blocks/420691002002016/
4.21E+14,6,1,0,0,1,0,1,9,12,21,42.85714286,57.14285714,institutionalized,http://www.prisonersofthecensus.org/data/2010blocks/420691002002047/
4.21E+14,4,1,0,0,0,0,2,7,29,36,19.44444444,80.55555556,institutionalized,http://www.prisonersofthecensus.org/data/2010blocks/420691002002061/
4.21E+14,234,3,1,0,51,5,87,381,442,823,46.29404617,53.70595383,tract,http://www.prisonersofthecensus.org/data/2010blocks/420691008001013/
4.21E+14,0,0,1,0,1,0,1,3,7,10,30,70,tract,http://www.prisonersofthecensus.org/data/2010blocks/420710123012016/
4.21E+14,224,10,3,0,109,35,240,621,494,1115,55.69506726,44.30493274,tract,http://www.prisonersofthecensus.org/data/2010blocks/420710007003002/
4.21E+14,88,0,0,0,0,0,7,95,128,223,42.60089686,57.39910314,tract,http://www.prisonersofthecensus.org/data/2010blocks/420730006001016/
4.21E+14,60,5,1,0,54,16,103,239,276,515,46.40776699,53.59223301,tract_part,http://www.prisonersofthecensus.org/data/2010blocks/420750033001026/
4.21E+14,3,0,0,0,4,0,4,11,22,33,33.33333333,66.66666667,tract,http://www.prisonersofthecensus.org/data/2010blocks/420770010002011/
4.21E+14,278,1,3,0,330,8,373,993,428,1421,69.88036594,30.11963406,tract,http://www.prisonersofthecensus.org/data/2010blocks/420770012001002/
4.21E+14,17,0,0,0,12,0,11,40,13,53,75.47169811,24.52830189,tract,http://www.prisonersofthecensus.org/data/2010blocks/420770097001014/
4.21E+14,34,0,0,0,29,1,34,98,83,181,54.14364641,45.85635359,tract,http://www.prisonersofthecensus.org/data/2010blocks/420770067011004/
4.21E+14,46,1,0,0,3,1,21,72,100,172,41.86046512,58.13953488,tract,http://www.prisonersofthecensus.org/data/2010blocks/420792175001048/
4.21E+14,1153,1,4,0,112,2,211,1483,716,2199,67.43974534,32.56025466,tract_part,http://www.prisonersofthecensus.org/data/2010blocks/420792113012015/
4.21E+14,554,0,5,0,117,11,135,822,424,1246,65.97110754,34.02889246,tract_part,http://www.prisonersofthecensus.org/data/2010blocks/420792156002005/
4.21E+14,4,0,1,0,0,0,1,6,15,21,28.57142857,71.42857143,institutionalized,http://www.prisonersofthecensus.org/data/2010blocks/420792012001029/
4.21E+14,33,0,0,0,2,1,11,47,97,144,32.63888889,67.36111111,remaining,http://www.prisonersofthecensus.org/data/2010blocks/420792012001030/
4.21E+14,122,0,0,0,5,1,47,175,304,479,36.53444676,63.46555324,institutionalized,http://www.prisonersofthecensus.org/data/2010blocks/420792012001042/
4.21E+14,531,2,2,0,60,16,74,685,818,1503,45.57551564,54.42448436,tract_part,http://www.prisonersofthecensus.org/data/2010blocks/420810117007000/
4.21E+14,18,1,0,0,0,0,0,19,99,118,16.10169492,83.89830508,tract,http://www.prisonersofthecensus.org/data/2010blocks/420810112001002/
4.21E+14,6,1,0,0,0,0,3,10,24,34,29.41176471,70.58823529,tract,http://www.prisonersofthecensus.org/data/2010blocks/420810003007027/
4.21E+14,100,1,0,0,3,0,4,108,103,211,51.18483412,48.81516588,tract,http://www.prisonersofthecensus.org/data/2010blocks/420810006003064/
4.21E+14,11,1,2,0,0,1,4,19,61,80,23.75,76.25,tract_part,http://www.prisonersofthecensus.org/data/2010blocks/420834208001111/
4.21E+14,820,4,6,0,0,12,390,1232,239,1471,83.75254929,16.24745071,tract_part,http://www.prisonersofthecensus.org/data/2010blocks/420834210002197/
4.21E+14,524,0,9,0,98,5,121,757,883,1640,46.15853659,53.84146341,tract_part,http://www.prisonersofthecensus.org/data/2010blocks/420850326022076/
4.21E+14,21,0,0,0,0,0,0,21,35,56,37.5,62.5,tract,http://www.prisonersofthecensus.org/data/2010blocks/420850301001027/
4.21E+14,6,0,0,0,0,0,4,10,45,55,18.18181818,81.81818182,tract,http://www.prisonersofthecensus.org/data/2010blocks/420879608003017/
4.21E+14,80,0,1,0,12,0,46,139,244,383,36.2924282,63.7075718,tract,http://www.prisonersofthecensus.org/data/2010blocks/420893011022032/
4.21E+14,892,0,6,0,27,4,69,998,858,1856,53.77155172,46.22844828,tract_part,http://www.prisonersofthecensus.org/data/2010blocks/420912060042007/
4.21E+14,2040,0,10,0,390,2,401,2843,940,3783,75.15199577,24.84800423,tract,http://www.prisonersofthecensus.org/data/2010blocks/420912067021003/
4.21E+14,0,0,0,0,0,0,1,1,21,22,4.545454545,95.45454545,tract,http://www.prisonersofthecensus.org/data/2010blocks/420930503002038/
4.21E+14,164,1,2,0,80,10,168,425,392,817,52.01958384,47.98041616,tract,http://www.prisonersofthecensus.org/data/2010blocks/420950143003001/
4.21E+14,81,0,2,0,26,1,26,136,86,222,61.26126126,38.73873874,institutionalized,http://www.prisonersofthecensus.org/data/2010blocks/420970812001009/
4.21E+14,877,1,3,0,128,7,142,1158,719,1877,61.69419286,38.30580714,institutionalized,http://www.prisonersofthecensus.org/data/2010blocks/420970812001128/
4.21E+14,30,1,0,0,6,6,22,65,148,213,30.51643192,69.48356808,tract,http://www.prisonersofthecensus.org/data/2010blocks/420970821001029/
4.21E+14,16,0,1,0,6,0,8,31,89,120,25.83333333,74.16666667,tract_part,http://www.prisonersofthecensus.org/data/2010blocks/420990305023017/
4.21E+14,624,5,19,0,25,20,246,939,118,1057,88.83632923,11.16367077,tract,http://www.prisonersofthecensus.org/data/2010blocks/421010005001000/
4.21E+14,47,0,0,0,0,5,6,58,10,68,85.29411765,14.70588235,tract,http://www.prisonersofthecensus.org/data/2010blocks/421010166002001/
4.21E+14,33,0,0,0,0,0,0,33,5,38,86.84210526,13.15789474,tract,http://www.prisonersofthecensus.org/data/2010blocks/421010169011000/
4.21E+14,191,2,1,0,3,3,29,229,39,268,85.44776119,14.55223881,tract,http://www.prisonersofthecensus.org/data/2010blocks/421010170003001/
4.21E+14,127,0,0,0,11,1,26,165,43,208,79.32692308,20.67307692,tract,http://www.prisonersofthecensus.org/data/2010blocks/421010173002027/
4.21E+14,36,0,1,0,4,1,15,57,11,68,83.82352941,16.17647059,tract,http://www.prisonersofthecensus.org/data/2010blocks/421010174001017/
4.21E+14,16,0,0,0,0,1,2,19,9,28,67.85714286,32.14285714,tract,http://www.prisonersofthecensus.org/data/2010blocks/421010175004006/
4.21E+14,2,1,0,0,7,0,14,24,0,24,100,0,tract,http://www.prisonersofthecensus.org/data/2010blocks/421010178002005/
4.21E+14,24,0,0,0,2,1,6,33,4,37,89.18918919,10.81081081,tract,http://www.prisonersofthecensus.org/data/2010blocks/421010202006001/
4.21E+14,13,0,0,0,0,0,2,15,3,18,83.33333333,16.66666667,tract,http://www.prisonersofthecensus.org/data/2010blocks/421010245002009/
4.21E+14,7,0,0,0,4,0,4,15,10,25,60,40,tract,http://www.prisonersofthecensus.org/data/2010blocks/421010252001004/
4.21E+14,0,0,0,0,0,0,0,0,2,2,0,100,tract,http://www.prisonersofthecensus.org/data/2010blocks/421010362011002/
4.21E+14,14,0,0,0,13,0,13,40,14,54,74.07407407,25.92592593,tract,http://www.prisonersofthecensus.org/data/2010blocks/421010376001023/
4.21E+14,285,0,1,1,16,0,50,353,50,403,87.59305211,12.40694789,institutionalized,http://www.prisonersofthecensus.org/data/2010blocks/421010383001029/
4.21E+14,469,0,12,0,54,0,94,629,83,712,88.34269663,11.65730337,institutionalized,http://www.prisonersofthecensus.org/data/2010blocks/421010383001043/
4.21E+14,30,0,0,0,12,2,17,61,9,70,87.14285714,12.85714286,institutionalized,http://www.prisonersofthecensus.org/data/2010blocks/421010383001044/
4.21E+14,3221,0,26,0,647,7,719,4620,612,5232,88.30275229,11.69724771,institutionalized,http://www.prisonersofthecensus.org/data/2010blocks/421019891001004/
4.21E+14,60,0,0,0,6,0,8,74,29,103,71.84466019,28.15533981,institutionalized,http://www.prisonersofthecensus.org/data/2010blocks/421019891001010/
4.21E+14,2163,0,25,0,456,4,488,3136,242,3378,92.83599763,7.164002368,institutionalized,http://www.prisonersofthecensus.org/data/2010blocks/421019891001016/
4.21E+14,88,1,4,0,20,3,39,155,203,358,43.29608939,56.70391061,tract,http://www.prisonersofthecensus.org/data/2010blocks/421039505011025/
4.21E+14,5,0,0,0,1,1,1,8,39,47,17.0212766,82.9787234,tract_part,http://www.prisonersofthecensus.org/data/2010blocks/421059503002035/
4.21E+14,840,0,0,0,287,0,295,1422,393,1815,78.34710744,21.65289256,tract_part,http://www.prisonersofthecensus.org/data/2010blocks/421070009005048/
4.21E+14,1213,0,8,1,238,0,283,1743,726,2469,70.59538275,29.40461725,tract_part,http://www.prisonersofthecensus.org/data/2010blocks/421070004003020/
4.21E+14,33,0,0,0,7,1,12,53,225,278,19.0647482,80.9352518,tract,http://www.prisonersofthecensus.org/data/2010blocks/421070019001011/
4.21E+14,557,0,5,0,144,0,147,853,402,1255,67.96812749,32.03187251,tract_part,http://www.prisonersofthecensus.org/data/2010blocks/421070004001084/
4.21E+14,8,1,0,0,1,2,6,18,89,107,16.82242991,83.17757009,institutionalized,http://www.prisonersofthecensus.org/data/2010blocks/421090702001069/
4.21E+14,35,0,2,0,1,0,5,43,286,329,13.06990881,86.93009119,institutionalized,http://www.prisonersofthecensus.org/data/2010blocks/421090702001144/
4.21E+14,7,0,0,0,0,0,0,7,65,72,9.722222222,90.27777778,tract,http://www.prisonersofthecensus.org/data/2010blocks/421110211001015/
4.21E+14,1171,1,15,0,247,2,247,1683,790,2473,68.05499393,31.94500607,tract,http://www.prisonersofthecensus.org/data/2010blocks/421110208004023/
4.21E+14,514,0,4,0,144,5,145,812,697,1509,53.81047051,46.18952949,tract_part,http://www.prisonersofthecensus.org/data/2010blocks/421110209003070/
4.21E+14,3,0,0,0,0,3,2,8,46,54,14.81481481,85.18518519,tract_part,http://www.prisonersofthecensus.org/data/2010blocks/421150326004132/
4.21E+14,1,0,0,0,2,1,3,7,77,84,8.333333333,91.66666667,tract_part,http://www.prisonersofthecensus.org/data/2010blocks/421179507003028/
4.21E+14,580,29,9,1,62,33,224,938,219,1157,81.07173725,18.92826275,institutionalized,http://www.prisonersofthecensus.org/data/2010blocks/421199801011005/
4.21E+14,513,20,44,3,110,52,414,1156,447,1603,72.11478478,27.88521522,institutionalized,http://www.prisonersofthecensus.org/data/2010blocks/421199801011018/
4.21E+14,786,22,20,1,188,70,461,1548,201,1749,88.5077187,11.4922813,institutionalized,http://www.prisonersofthecensus.org/data/2010blocks/421199801011034/
4.21E+14,831,35,25,5,202,63,509,1670,394,2064,80.91085271,19.08914729,tract,http://www.prisonersofthecensus.org/data/2010blocks/421199805011020/
4.21E+14,2,0,0,0,0,0,0,2,32,34,5.882352941,94.11764706,tract_part,http://www.prisonersofthecensus.org/data/2010blocks/421190907002016/
4.21E+14,12,0,0,0,0,1,2,15,117,132,11.36363636,88.63636364,tract,http://www.prisonersofthecensus.org/data/2010blocks/421212005001008/
4.21E+14,23,2,0,1,2,0,2,30,133,163,18.40490798,81.59509202,tract_part,http://www.prisonersofthecensus.org/data/2010blocks/421239706001042/
4.21E+14,3,2,0,0,2,0,0,7,114,121,5.785123967,94.21487603,tract,http://www.prisonersofthecensus.org/data/2010blocks/421239708001019/
4.21E+14,0,0,0,0,0,0,1,1,2,3,33.33333333,66.66666667,tract,http://www.prisonersofthecensus.org/data/2010blocks/421239709002010/
4.21E+14,113,0,0,0,3,3,8,127,236,363,34.9862259,65.0137741,tract,http://www.prisonersofthecensus.org/data/2010blocks/421257041001013/
4.21E+14,445,0,5,0,128,5,137,720,976,1696,42.45283019,57.54716981,institutionalized,http://www.prisonersofthecensus.org/data/2010blocks/421279609002060/
4.21E+14,722,34,16,0,141,65,396,1374,348,1722,79.79094077,20.20905923,institutionalized,http://www.prisonersofthecensus.org/data/2010blocks/421279609002083/
4.21E+14,8,0,0,0,2,2,10,22,107,129,17.05426357,82.94573643,tract_part,http://www.prisonersofthecensus.org/data/2010blocks/421279608002056/
4.21E+14,36,0,0,0,0,0,1,37,40,77,48.05194805,51.94805195,tract,http://www.prisonersofthecensus.org/data/2010blocks/421298001001021/
4.21E+14,95,1,0,0,4,1,9,110,382,492,22.35772358,77.64227642,institutionalized,http://www.prisonersofthecensus.org/data/2010blocks/421298047023000/
4.21E+14,468,0,4,0,92,0,91,655,414,1069,61.27221703,38.72778297,remaining,http://www.prisonersofthecensus.org/data/2010blocks/421298047023015/
4.21E+14,3,1,0,0,0,1,0,5,53,58,8.620689655,91.37931034,tract_part,http://www.prisonersofthecensus.org/data/2010blocks/421314006002041/
4.21E+14,482,0,1,0,1102,5,942,2532,909,3441,73.58326068,26.41673932,tract_part,http://www.prisonersofthecensus.org/data/2010blocks/421330101101008/
4.21E+14,8,0,0,0,0,0,3,11,7,18,61.11111111,38.88888889,tract,http://www.prisonersofthecensus.org/data/2010blocks/421330001002016/
4.21E+14,4,0,0,0,1,0,2,7,10,17,41.17647059,58.82352941,tract,http://www.prisonersofthecensus.org/data/2010blocks/421330002002015/
4.21E+14,8,0,0,0,0,0,2,10,3,13,76.92307692,23.07692308,tract,http://www.prisonersofthecensus.org/data/2010blocks/421330008001014/
4.21E+14,8,0,0,0,1,1,3,13,26,39,33.33333333,66.66666667,tract,http://www.prisonersofthecensus.org/data/2010blocks/421330016002015/
7.20E+14,87,2,1,0,83,21,708,902,6,908,99.33920705,0.660792952,tract_part,http://www.prisonersofthecensus.org/data/2010blocks/720054014011028/
7.20E+14,6,0,0,0,10,1,69,86,0,86,100,0,tract,http://www.prisonersofthecensus.org/data/2010blocks/720133013001003/
7.20E+14,30,1,1,0,34,13,257,336,11,347,96.82997118,3.170028818,tract_part,http://www.prisonersofthecensus.org/data/2010blocks/720133019003069/
7.20E+14,40,0,0,0,55,11,380,486,14,500,97.2,2.8,tract,http://www.prisonersofthecensus.org/data/2010blocks/720133023001003/
7.20E+14,0,0,0,0,5,1,18,24,0,24,100,0,tract,http://www.prisonersofthecensus.org/data/2010blocks/720199524002023/
7.20E+14,12,0,0,0,1,2,39,54,0,54,100,0,tract,http://www.prisonersofthecensus.org/data/2010blocks/720210310211028/
7.20E+14,477,0,0,0,50,26,1580,2133,9,2142,99.57983193,0.420168067,institutionalized,http://www.prisonersofthecensus.org/data/2010blocks/720210301011023/
7.20E+14,323,0,0,0,16,0,1007,1346,0,1346,100,0,institutionalized,http://www.prisonersofthecensus.org/data/2010blocks/720210301011025/
7.20E+14,7,0,0,0,5,1,97,110,3,113,97.34513274,2.654867257,tract,http://www.prisonersofthecensus.org/data/2010blocks/720210301032006/
7.20E+14,0,0,0,0,0,0,11,11,0,11,100,0,tract_part,http://www.prisonersofthecensus.org/data/2010blocks/720475302001014/
7.21E+14,1,0,0,0,19,0,31,51,2,53,96.22641509,3.773584906,tract,http://www.prisonersofthecensus.org/data/2010blocks/720531503022013/
7.21E+14,776,82,4,1,31,32,2018,2944,15,2959,99.49307198,0.506928016,tract_part,http://www.prisonersofthecensus.org/data/2010blocks/720572702022191/
7.21E+14,472,13,5,0,26,3,1205,1724,7,1731,99.59560947,0.404390526,tract,http://www.prisonersofthecensus.org/data/2010blocks/720610402001017/
7.21E+14,9,0,0,0,24,0,51,84,0,84,100,0,tract_part,http://www.prisonersofthecensus.org/data/2010blocks/720691806005065/
7.21E+14,8,0,0,0,0,0,14,22,0,22,100,0,tract_part,http://www.prisonersofthecensus.org/data/2010blocks/720739562004078/
7.21E+14,77,45,0,0,184,24,658,988,8,996,99.19678715,0.803212851,tract_part,http://www.prisonersofthecensus.org/data/2010blocks/720970808001019/
7.21E+14,2,14,0,0,0,0,26,42,0,42,100,0,tract_part,http://www.prisonersofthecensus.org/data/2010blocks/721079550011015/
7.21E+14,274,4,0,0,42,22,3372,3714,48,3762,98.72408293,1.275917065,tract,http://www.prisonersofthecensus.org/data/2010blocks/721130730081000/
7.21E+14,116,26,0,0,286,5,766,1199,14,1213,98.84583677,1.154163232,tract_part,http://www.prisonersofthecensus.org/data/2010blocks/721191306021097/
7.21E+14,11,0,0,0,0,0,29,40,0,40,100,0,tract,http://www.prisonersofthecensus.org/data/2010blocks/721270007002026/
7.21E+14,5,0,0,0,6,0,15,26,0,26,100,0,tract_part,http://www.prisonersofthecensus.org/data/2010blocks/721390603012007/
7.21E+14,85,3,0,0,1,1,270,360,22,382,94.2408377,5.759162304,tract_part,http://www.prisonersofthecensus.org/data/2010blocks/721435505003005/
7.22E+14,9,24,0,0,0,0,50,83,0,83,100,0,tract_part,http://www.prisonersofthecensus.org/data/2010blocks/721519508003030/
4.40E+14,114,8,10,0,86,29,172,419,71,490,85.51020408,14.48979592,tract,http://www.prisonersofthecensus.org/data/2010blocks/440070109001014/
4.40E+14,36,1,0,0,1,0,11,49,38,87,56.32183908,43.67816092,institutionalized,http://www.prisonersofthecensus.org/data/2010blocks/440070142002023/
4.40E+14,248,7,10,0,200,0,289,754,354,1108,68.05054152,31.94945848,institutionalized,http://www.prisonersofthecensus.org/data/2010blocks/440070142002025/
4.40E+14,14,2,0,0,5,0,7,28,59,87,32.18390805,67.81609195,remaining,http://www.prisonersofthecensus.org/data/2010blocks/440070142002030/
4.40E+14,278,6,18,0,196,1,195,694,543,1237,56.10347615,43.89652385,institutionalized,http://www.prisonersofthecensus.org/data/2010blocks/440070142002037/
4.40E+14,135,1,2,0,2,0,109,249,212,461,54.01301518,45.98698482,institutionalized,http://www.prisonersofthecensus.org/data/2010blocks/440070142002053/
4.40E+14,94,1,2,0,70,0,75,242,138,380,63.68421053,36.31578947,institutionalized,http://www.prisonersofthecensus.org/data/2010blocks/440070142002055/
4.40E+14,27,1,2,0,0,0,2,32,73,105,30.47619048,69.52380952,institutionalized,http://www.prisonersofthecensus.org/data/2010blocks/440070142002061/
4.40E+14,188,0,2,0,0,1,50,241,197,438,55.02283105,44.97716895,institutionalized,http://www.prisonersofthecensus.org/data/2010blocks/440070142002072/
4.50E+14,50,0,0,0,1,0,1,52,28,80,65,35,tract_part,http://www.prisonersofthecensus.org/data/2010blocks/450019504004030/
4.50E+14,325,1,0,0,0,0,2,328,203,531,61.77024482,38.22975518,tract_part,http://www.prisonersofthecensus.org/data/2010blocks/450030216013014/
4.50E+14,26,0,0,0,0,0,1,27,2,29,93.10344828,6.896551724,tract_part,http://www.prisonersofthecensus.org/data/2010blocks/450059702005034/
4.50E+14,832,1,2,0,24,0,29,888,371,1259,70.53216839,29.46783161,tract_part,http://www.prisonersofthecensus.org/data/2010blocks/450059704003007/
4.50E+14,66,0,0,0,0,0,11,77,54,131,58.77862595,41.22137405,tract_part,http://www.prisonersofthecensus.org/data/2010blocks/450070123001056/
4.50E+14,168,0,0,0,2,2,13,185,185,370,50,50,tract_part,http://www.prisonersofthecensus.org/data/2010blocks/450070010001058/
4.50E+14,36,0,0,0,0,0,1,37,9,46,80.43478261,19.56521739,tract_part,http://www.prisonersofthecensus.org/data/2010blocks/450099602002031/
4.50E+14,48,0,0,0,0,0,1,49,21,70,70,30,tract_part,http://www.prisonersofthecensus.org/data/2010blocks/450119704003032/
4.50E+14,122,0,1,0,9,7,33,172,38,210,81.9047619,18.0952381,tract_part,http://www.prisonersofthecensus.org/data/2010blocks/450130007001000/
4.50E+14,324,4,2,0,8,0,8,346,225,571,60.59544658,39.40455342,tract,http://www.prisonersofthecensus.org/data/2010blocks/450150201023006/
4.50E+14,48,7,2,0,5,6,23,91,81,172,52.90697674,47.09302326,tract_part,http://www.prisonersofthecensus.org/data/2010blocks/450150210001042/
4.50E+14,186,0,0,0,0,0,2,188,149,337,55.78635015,44.21364985,tract_part,http://www.prisonersofthecensus.org/data/2010blocks/450150205042003/
4.50E+14,1316,2,2,0,0,0,131,1451,333,1784,81.33408072,18.66591928,tract_part,http://www.prisonersofthecensus.org/data/2010blocks/450190039002053/
4.50E+14,23,0,0,0,0,0,0,23,56,79,29.11392405,70.88607595,tract_part,http://www.prisonersofthecensus.org/data/2010blocks/450219702011052/
4.50E+14,70,0,0,0,0,0,5,75,30,105,71.42857143,28.57142857,tract_part,http://www.prisonersofthecensus.org/data/2010blocks/450230203002005/
4.50E+14,70,3,0,0,0,0,4,77,37,114,67.54385965,32.45614035,tract_part,http://www.prisonersofthecensus.org/data/2010blocks/450259504002030/
4.50E+14,74,0,0,0,0,0,1,75,18,93,80.64516129,19.35483871,tract_part,http://www.prisonersofthecensus.org/data/2010blocks/450279607013003/
4.50E+14,960,3,1,0,16,0,19,999,408,1407,71.0021322,28.9978678,tract,http://www.prisonersofthecensus.org/data/2010blocks/450279602012004/
4.50E+14,37,0,0,0,0,0,0,37,8,45,82.22222222,17.77777778,institutionalized,http://www.prisonersofthecensus.org/data/2010blocks/450310109003006/
4.50E+14,138,0,0,0,0,0,1,139,41,180,77.22222222,22.77777778,institutionalized,http://www.prisonersofthecensus.org/data/2010blocks/450310109003007/
4.50E+14,134,2,2,0,2,0,2,142,30,172,82.55813953,17.44186047,tract_part,http://www.prisonersofthecensus.org/data/2010blocks/450339704001001/
4.50E+14,998,4,0,0,25,0,28,1055,354,1409,74.87579844,25.12420156,tract_part,http://www.prisonersofthecensus.org/data/2010blocks/450350104001051/
4.50E+14,124,1,0,0,0,0,1,126,90,216,58.33333333,41.66666667,tract_part,http://www.prisonersofthecensus.org/data/2010blocks/450350102004035/
4.50E+14,1068,16,8,4,162,88,517,1863,483,2346,79.41176471,20.58823529,institutionalized,http://www.prisonersofthecensus.org/data/2010blocks/450379702023049/
4.50E+14,55,0,0,0,0,0,2,57,27,84,67.85714286,32.14285714,institutionalized,http://www.prisonersofthecensus.org/data/2010blocks/450379702025051/
4.50E+14,450,0,1,0,11,1,8,471,163,634,74.29022082,25.70977918,tract_part,http://www.prisonersofthecensus.org/data/2010blocks/450379704002091/
4.50E+14,59,0,0,0,0,0,1,60,12,72,83.33333333,16.66666667,tract_part,http://www.prisonersofthecensus.org/data/2010blocks/450399602003068/
4.50E+14,207,2,0,0,0,0,1,210,56,266,78.94736842,21.05263158,tract_part,http://www.prisonersofthecensus.org/data/2010blocks/450410001011016/
4.50E+14,272,0,0,0,2,0,8,282,66,348,81.03448276,18.96551724,tract_part,http://www.prisonersofthecensus.org/data/2010blocks/450410016022033/
4.50E+14,144,0,0,0,1,1,8,154,64,218,70.64220183,29.35779817,tract,http://www.prisonersofthecensus.org/data/2010blocks/450439203012027/
4.50E+14,579,0,2,0,25,2,68,676,528,1204,56.1461794,43.8538206,tract,http://www.prisonersofthecensus.org/data/2010blocks/450450001002014/
4.50E+14,581,0,3,0,23,2,24,633,411,1044,60.63218391,39.36781609,tract_part,http://www.prisonersofthecensus.org/data/2010blocks/450450032013016/
4.50E+14,80,0,0,0,0,1,8,89,66,155,57.41935484,42.58064516,tract_part,http://www.prisonersofthecensus.org/data/2010blocks/450479704002009/
4.50E+14,209,2,0,0,8,1,16,236,325,561,42.06773619,57.93226381,institutionalized,http://www.prisonersofthecensus.org/data/2010blocks/450479702011007/
4.50E+14,64,1,0,0,1,0,3,69,65,134,51.49253731,48.50746269,institutionalized,http://www.prisonersofthecensus.org/data/2010blocks/450479702011011/
4.50E+14,741,23,8,6,115,39,344,1276,239,1515,84.22442244,15.77557756,tract_part,http://www.prisonersofthecensus.org/data/2010blocks/450499204004097/
4.50E+14,52,0,0,0,0,0,0,52,4,56,92.85714286,7.142857143,tract_part,http://www.prisonersofthecensus.org/data/2010blocks/450499202003027/
4.51E+14,267,1,0,1,4,3,50,326,353,679,48.01178203,51.98821797,tract_part,http://www.prisonersofthecensus.org/data/2010blocks/450510707012041/
4.51E+14,891,39,6,2,0,1,68,1007,341,1348,74.70326409,25.29673591,institutionalized,http://www.prisonersofthecensus.org/data/2010blocks/450539502023026/
4.51E+14,53,0,1,0,0,0,4,58,17,75,77.33333333,22.66666667,institutionalized,http://www.prisonersofthecensus.org/data/2010blocks/450539502023046/
4.51E+14,1006,4,3,0,47,1,61,1122,462,1584,70.83333333,29.16666667,tract_part,http://www.prisonersofthecensus.org/data/2010blocks/450570102002000/
4.51E+14,78,0,0,0,0,0,2,80,56,136,58.82352941,41.17647059,tract_part,http://www.prisonersofthecensus.org/data/2010blocks/450570110021064/
4.51E+14,97,0,0,0,0,1,5,103,88,191,53.92670157,46.07329843,tract_part,http://www.prisonersofthecensus.org/data/2010blocks/450599203022014/
4.51E+14,1268,11,4,0,21,2,58,1364,458,1822,74.86278814,25.13721186,tract_part,http://www.prisonersofthecensus.org/data/2010blocks/450619203023044/
4.51E+14,409,0,2,0,2,0,53,466,396,862,54.06032483,45.93967517,tract_part,http://www.prisonersofthecensus.org/data/2010blocks/450630210291010/
4.51E+14,858,3,1,1,3,0,27,893,357,1250,71.44,28.56,tract_part,http://www.prisonersofthecensus.org/data/2010blocks/450659202002047/
4.51E+14,49,1,0,0,0,0,1,51,15,66,77.27272727,22.72727273,tract_part,http://www.prisonersofthecensus.org/data/2010blocks/450699602004036/
4.51E+14,1030,12,2,1,40,9,71,1165,468,1633,71.34109002,28.65890998,tract_part,http://www.prisonersofthecensus.org/data/2010blocks/450699603022052/
4.51E+14,838,26,3,0,176,46,456,1545,151,1696,91.09669811,8.903301887,tract_part,http://www.prisonersofthecensus.org/data/2010blocks/450699603022049/
4.51E+14,88,0,0,0,0,1,10,99,23,122,81.14754098,18.85245902,tract_part,http://www.prisonersofthecensus.org/data/2010blocks/450719505022023/
4.51E+14,41,0,0,0,0,0,2,43,118,161,26.70807453,73.29192547,tract_part,http://www.prisonersofthecensus.org/data/2010blocks/450730304012003/
4.51E+14,0,0,0,0,0,0,0,0,4,4,0,100,tract,http://www.prisonersofthecensus.org/data/2010blocks/450730305001011/
4.51E+14,255,0,0,0,4,0,8,267,45,312,85.57692308,14.42307692,tract_part,http://www.prisonersofthecensus.org/data/2010blocks/450750110003045/
4.51E+14,21,0,0,0,1,0,7,29,77,106,27.35849057,72.64150943,tract_part,http://www.prisonersofthecensus.org/data/2010blocks/450770104025056/
4.51E+14,28,0,0,0,0,0,0,28,74,102,27.45098039,72.54901961,tract_part,http://www.prisonersofthecensus.org/data/2010blocks/450770102002074/
4.51E+14,131,0,3,0,0,0,1,135,15,150,90,10,institutionalized,http://www.prisonersofthecensus.org/data/2010blocks/450790031001006/
4.51E+14,32,0,0,0,0,0,1,33,8,41,80.48780488,19.51219512,institutionalized,http://www.prisonersofthecensus.org/data/2010blocks/450790031001039/
4.51E+14,116,0,0,0,0,0,0,116,29,145,80,20,tract_part,http://www.prisonersofthecensus.org/data/2010blocks/450790108061022/
4.51E+14,778,0,0,1,0,3,9,791,130,921,85.88490771,14.11509229,tract_part,http://www.prisonersofthecensus.org/data/2010blocks/450790117021034/
4.51E+14,170,1,0,0,0,0,1,172,72,244,70.49180328,29.50819672,institutionalized,http://www.prisonersofthecensus.org/data/2010blocks/450790104081005/
4.51E+14,238,0,0,1,5,0,6,250,75,325,76.92307692,23.07692308,institutionalized,http://www.prisonersofthecensus.org/data/2010blocks/450790104081007/
4.51E+14,2807,9,5,0,87,5,100,3013,1658,4671,64.50438878,35.49561122,institutionalized,http://www.prisonersofthecensus.org/data/2010blocks/450790104081009/
4.51E+14,265,2,1,0,6,0,5,279,130,409,68.21515892,31.78484108,institutionalized,http://www.prisonersofthecensus.org/data/2010blocks/450790104081010/
4.51E+14,253,1,0,0,0,0,0,254,143,397,63.97984887,36.02015113,institutionalized,http://www.prisonersofthecensus.org/data/2010blocks/450790104081012/
4.51E+14,686,0,8,0,61,0,63,818,537,1355,60.36900369,39.63099631,tract,http://www.prisonersofthecensus.org/data/2010blocks/450830238022101/
4.51E+14,282,0,3,0,3,0,3,291,234,525,55.42857143,44.57142857,tract_part,http://www.prisonersofthecensus.org/data/2010blocks/450830218023021/
4.51E+14,27,0,0,0,0,0,7,34,67,101,33.66336634,66.33663366,tract_part,http://www.prisonersofthecensus.org/data/2010blocks/450830212001082/
4.51E+14,337,0,1,0,0,1,58,397,290,687,57.7874818,42.2125182,tract_part,http://www.prisonersofthecensus.org/data/2010blocks/450830216002042/
4.51E+14,613,2,1,0,2,0,2,620,243,863,71.8424102,28.1575898,tract_part,http://www.prisonersofthecensus.org/data/2010blocks/450850001001063/
4.51E+14,40,0,0,0,0,0,1,41,39,80,51.25,48.75,tract_part,http://www.prisonersofthecensus.org/data/2010blocks/450870304003007/
4.51E+14,65,0,0,0,0,0,0,65,7,72,90.27777778,9.722222222,tract_part,http://www.prisonersofthecensus.org/data/2010blocks/450899706005036/
4.51E+14,640,18,10,1,155,38,359,1221,145,1366,89.38506589,10.61493411,tract,http://www.prisonersofthecensus.org/data/2010blocks/450899708021000/
4.51E+14,0,0,0,0,0,0,0,0,1,1,0,100,tract_part,http://www.prisonersofthecensus.org/data/2010blocks/450910611013019/
4.51E+14,111,0,0,0,2,0,1,114,74,188,60.63829787,39.36170213,tract_part,http://www.prisonersofthecensus.org/data/2010blocks/450910614031056/
4.51E+14,159,4,2,0,13,2,16,196,143,339,57.81710914,42.18289086,tract_part,http://www.prisonersofthecensus.org/data/2010blocks/450910615021010/
4.60E+14,0,6,0,0,1,0,3,10,17,27,37.03703704,62.96296296,tract,http://www.prisonersofthecensus.org/data/2010blocks/460059569002074/
4.60E+14,52,429,2,0,12,30,71,596,671,1267,47.04025257,52.95974743,tract_part,http://www.prisonersofthecensus.org/data/2010blocks/460099677002173/
4.60E+14,0,0,0,0,0,0,0,0,1,1,0,100,tract_part,http://www.prisonersofthecensus.org/data/2010blocks/460099676002169/
4.60E+14,2,1,0,0,0,0,0,3,17,20,15,85,tract_part,http://www.prisonersofthecensus.org/data/2010blocks/460119588025019/
4.60E+14,0,8,0,0,0,0,1,9,35,44,20.45454545,79.54545455,tract,http://www.prisonersofthecensus.org/data/2010blocks/460139515003026/
4.60E+14,1,7,0,0,0,0,0,8,6,14,57.14285714,42.85714286,tract_part,http://www.prisonersofthecensus.org/data/2010blocks/460159732003038/
4.60E+14,0,41,0,0,0,0,0,41,2,43,95.34883721,4.651162791,tract_part,http://www.prisonersofthecensus.org/data/2010blocks/460239402001243/
4.60E+14,1,0,0,0,1,0,1,3,7,10,30,70,tract_part,http://www.prisonersofthecensus.org/data/2010blocks/460279659001039/
4.60E+14,3,8,0,0,0,0,0,11,46,57,19.29824561,80.70175439,tract,http://www.prisonersofthecensus.org/data/2010blocks/460299544002031/
4.60E+14,3,40,0,1,0,3,2,49,55,104,47.11538462,52.88461538,tract_part,http://www.prisonersofthecensus.org/data/2010blocks/460359629001020/
4.60E+14,0,7,0,0,1,0,2,10,2,12,83.33333333,16.66666667,tract_part,http://www.prisonersofthecensus.org/data/2010blocks/460379528001091/
4.60E+14,0,4,0,0,0,0,0,4,4,8,50,50,tract_part,http://www.prisonersofthecensus.org/data/2010blocks/460459621002065/
4.60E+14,0,0,0,0,0,0,0,0,6,6,0,100,tract_part,http://www.prisonersofthecensus.org/data/2010blocks/460479642001050/
4.61E+14,0,0,0,0,0,0,0,0,2,2,0,100,tract_part,http://www.prisonersofthecensus.org/data/2010blocks/460499611001064/
4.61E+14,1,1,0,0,0,0,0,2,12,14,14.28571429,85.71428571,tract_part,http://www.prisonersofthecensus.org/data/2010blocks/460519531004015/
4.61E+14,10,281,1,0,4,9,30,335,199,534,62.7340824,37.2659176,tract_part,http://www.prisonersofthecensus.org/data/2010blocks/460659778003009/
4.61E+14,0,2,0,0,0,0,0,2,13,15,13.33333333,86.66666667,tract_part,http://www.prisonersofthecensus.org/data/2010blocks/460799602004031/
4.61E+14,0,4,0,0,0,3,2,9,21,30,30,70,tract_part,http://www.prisonersofthecensus.org/data/2010blocks/460819661004042/
4.61E+14,0,0,0,0,0,0,0,0,3,3,0,100,tract_part,http://www.prisonersofthecensus.org/data/2010blocks/460919508003097/
4.61E+14,1,5,0,0,0,2,3,11,36,47,23.40425532,76.59574468,tract_part,http://www.prisonersofthecensus.org/data/2010blocks/460930204004025/
4.61E+14,8,19,0,0,5,0,7,39,118,157,24.84076433,75.15923567,institutionalized,http://www.prisonersofthecensus.org/data/2010blocks/460990001001117/
4.61E+14,100,307,4,1,29,32,68,541,979,1520,35.59210526,64.40789474,institutionalized,http://www.prisonersofthecensus.org/data/2010blocks/460990001003000/
4.61E+14,61,78,2,3,13,3,34,194,212,406,47.78325123,52.21674877,institutionalized,http://www.prisonersofthecensus.org/data/2010blocks/460990001004026/
4.61E+14,1,15,0,0,0,1,0,17,11,28,60.71428571,39.28571429,institutionalized,http://www.prisonersofthecensus.org/data/2010blocks/460990015006036/
4.61E+14,0,3,0,0,0,0,0,3,9,12,25,75,institutionalized,http://www.prisonersofthecensus.org/data/2010blocks/460990015006038/
4.61E+14,6,210,1,0,0,0,1,218,160,378,57.67195767,42.32804233,institutionalized,http://www.prisonersofthecensus.org/data/2010blocks/461030102002020/
4.61E+14,2,21,0,0,0,3,0,26,52,78,33.33333333,66.66666667,institutionalized,http://www.prisonersofthecensus.org/data/2010blocks/461030102004032/
4.61E+14,0,11,0,0,0,0,1,12,7,19,63.15789474,36.84210526,tract,http://www.prisonersofthecensus.org/data/2010blocks/461030104002016/
4.61E+14,0,90,0,0,2,7,10,109,51,160,68.125,31.875,tract_part,http://www.prisonersofthecensus.org/data/2010blocks/461030109051029/
4.61E+14,1,25,0,0,0,6,4,36,67,103,34.95145631,65.04854369,tract_part,http://www.prisonersofthecensus.org/data/2010blocks/461030109071048/
4.61E+14,0,12,0,0,0,0,0,12,0,12,100,0,tract_part,http://www.prisonersofthecensus.org/data/2010blocks/461099408001096/
4.61E+14,0,27,0,0,0,0,0,27,0,27,100,0,tract_part,http://www.prisonersofthecensus.org/data/2010blocks/461219401002033/
4.61E+14,0,43,0,0,0,1,2,46,8,54,85.18518519,14.81481481,tract_part,http://www.prisonersofthecensus.org/data/2010blocks/461239717002120/
4.61E+14,0,1,0,0,1,0,1,3,11,14,21.42857143,78.57142857,tract_part,http://www.prisonersofthecensus.org/data/2010blocks/461270202002035/
4.61E+14,0,9,0,0,0,0,0,9,3,12,75,25,tract_part,http://www.prisonersofthecensus.org/data/2010blocks/461299651001087/
4.61E+14,10,103,2,0,5,8,6,134,163,297,45.11784512,54.88215488,tract_part,http://www.prisonersofthecensus.org/data/2010blocks/461359663012015/
4.61E+14,2,1,0,0,0,0,0,3,33,36,8.333333333,91.66666667,tract,http://www.prisonersofthecensus.org/data/2010blocks/461359661004010/
4.61E+14,211,33,21,2,54,15,133,469,461,930,50.43010753,49.56989247,tract,http://www.prisonersofthecensus.org/data/2010blocks/461359663022016/
4.70E+14,43,0,0,0,0,0,4,47,193,240,19.58333333,80.41666667,tract_part,http://www.prisonersofthecensus.org/data/2010blocks/470010212011001/
4.70E+14,27,0,0,0,0,0,13,40,73,113,35.39823009,64.60176991,tract_part,http://www.prisonersofthecensus.org/data/2010blocks/470039504012000/
4.70E+14,14,0,0,0,0,0,6,20,44,64,31.25,68.75,tract_part,http://www.prisonersofthecensus.org/data/2010blocks/470039504013003/
4.70E+14,4,0,0,0,0,0,0,4,39,43,9.302325581,90.69767442,tract_part,http://www.prisonersofthecensus.org/data/2010blocks/470059633001015/
4.70E+14,285,1,0,0,4,7,12,309,537,846,36.5248227,63.4751773,institutionalized,http://www.prisonersofthecensus.org/data/2010blocks/470079532001050/
4.70E+14,24,0,0,0,0,0,0,24,65,89,26.96629213,73.03370787,institutionalized,http://www.prisonersofthecensus.org/data/2010blocks/470079532001056/
4.70E+14,0,0,0,0,0,0,0,0,17,17,0,100,tract_part,http://www.prisonersofthecensus.org/data/2010blocks/470079531003063/
4.70E+14,60,0,1,0,9,5,14,89,262,351,25.35612536,74.64387464,tract_part,http://www.prisonersofthecensus.org/data/2010blocks/470090106001007/
4.70E+14,78,2,1,0,4,11,15,111,253,364,30.49450549,69.50549451,tract,http://www.prisonersofthecensus.org/data/2010blocks/470110107003006/
4.70E+14,0,0,0,0,0,0,1,1,133,134,0.746268657,99.25373134,tract_part,http://www.prisonersofthecensus.org/data/2010blocks/470139505003004/
4.70E+14,1,0,1,0,0,0,1,3,53,56,5.357142857,94.64285714,tract_part,http://www.prisonersofthecensus.org/data/2010blocks/470159601002056/
4.70E+14,22,0,0,0,2,0,2,26,75,101,25.74257426,74.25742574,tract_part,http://www.prisonersofthecensus.org/data/2010blocks/470179621001118/
4.70E+14,57,0,0,0,0,0,0,57,117,174,32.75862069,67.24137931,tract_part,http://www.prisonersofthecensus.org/data/2010blocks/470190717003022/
4.70E+14,5,0,0,0,0,0,0,5,183,188,2.659574468,97.34042553,tract_part,http://www.prisonersofthecensus.org/data/2010blocks/470190701002044/
4.70E+14,3,1,0,0,2,2,3,11,103,114,9.649122807,90.35087719,tract_part,http://www.prisonersofthecensus.org/data/2010blocks/470210703001030/
4.70E+14,8,0,0,0,0,0,0,8,15,23,34.7826087,65.2173913,tract_part,http://www.prisonersofthecensus.org/data/2010blocks/470239702002024/
4.70E+14,8,0,0,0,0,0,3,11,171,182,6.043956044,93.95604396,tract_part,http://www.prisonersofthecensus.org/data/2010blocks/470259709002043/
4.70E+14,0,0,0,0,0,0,0,0,20,20,0,100,tract_part,http://www.prisonersofthecensus.org/data/2010blocks/470279550004036/
4.70E+14,4,0,0,0,0,0,0,4,45,49,8.163265306,91.83673469,institutionalized,http://www.prisonersofthecensus.org/data/2010blocks/470299202004050/
4.70E+14,1,0,0,0,0,0,0,1,21,22,4.545454545,95.45454545,institutionalized,http://www.prisonersofthecensus.org/data/2010blocks/470299202004061/
4.70E+14,18,0,0,0,0,0,0,18,198,216,8.333333333,91.66666667,tract_part,http://www.prisonersofthecensus.org/data/2010blocks/470319704003001/
4.70E+14,0,0,0,0,2,0,3,5,140,145,3.448275862,96.55172414,tract_part,http://www.prisonersofthecensus.org/data/2010blocks/470359705021005/
4.70E+14,23,1,0,0,0,0,0,24,111,135,17.77777778,82.22222222,institutionalized,http://www.prisonersofthecensus.org/data/2010blocks/470370128024022/
4.70E+14,161,1,1,1,2,0,13,179,455,634,28.23343849,71.76656151,institutionalized,http://www.prisonersofthecensus.org/data/2010blocks/470370128024025/
4.70E+14,28,1,0,0,0,0,1,30,56,86,34.88372093,65.11627907,institutionalized,http://www.prisonersofthecensus.org/data/2010blocks/470370128024029/
4.70E+14,389,0,2,0,0,2,49,442,190,632,69.93670886,30.06329114,tract_part,http://www.prisonersofthecensus.org/data/2010blocks/470370195004008/
4.70E+14,1,0,0,0,0,0,0,1,5,6,16.66666667,83.33333333,tract_part,http://www.prisonersofthecensus.org/data/2010blocks/470370121003004/
4.70E+14,22,0,0,0,0,0,0,22,86,108,20.37037037,79.62962963,tract,http://www.prisonersofthecensus.org/data/2010blocks/470370155013000/
4.70E+14,361,0,1,0,0,1,12,375,114,489,76.68711656,23.31288344,tract_part,http://www.prisonersofthecensus.org/data/2010blocks/470370195004002/
4.70E+14,928,8,4,0,16,19,53,1028,926,1954,52.61003071,47.38996929,tract,http://www.prisonersofthecensus.org/data/2010blocks/470370130001009/
4.70E+14,1405,9,11,1,45,26,137,1634,864,2498,65.41232986,34.58767014,tract,http://www.prisonersofthecensus.org/data/2010blocks/470370156133005/
4.70E+14,7,0,0,0,0,0,0,7,20,27,25.92592593,74.07407407,tract_part,http://www.prisonersofthecensus.org/data/2010blocks/470399551012069/
4.70E+14,2,0,0,0,1,2,5,10,76,86,11.62790698,88.37209302,tract_part,http://www.prisonersofthecensus.org/data/2010blocks/470419202003082/
4.70E+14,34,0,0,0,3,0,9,46,184,230,20,80,tract_part,http://www.prisonersofthecensus.org/data/2010blocks/470430602003071/
4.70E+14,76,2,0,0,0,1,1,80,109,189,42.32804233,57.67195767,tract_part,http://www.prisonersofthecensus.org/data/2010blocks/470459644002001/
4.70E+14,71,0,0,0,0,0,5,76,27,103,73.78640777,26.21359223,tract_part,http://www.prisonersofthecensus.org/data/2010blocks/470470605011000/
4.71E+14,0,0,0,0,0,0,0,0,32,32,0,100,tract_part,http://www.prisonersofthecensus.org/data/2010blocks/470499651004029/
4.71E+14,15,0,0,0,0,0,2,17,105,122,13.93442623,86.06557377,tract_part,http://www.prisonersofthecensus.org/data/2010blocks/470519604004143/
4.71E+14,12,0,0,0,1,0,1,14,4,18,77.77777778,22.22222222,tract_part,http://www.prisonersofthecensus.org/data/2010blocks/470539669002058/
4.71E+14,76,0,0,0,2,0,2,80,73,153,52.2875817,47.7124183,tract_part,http://www.prisonersofthecensus.org/data/2010blocks/470539667001061/
4.71E+14,39,0,0,0,0,0,1,40,84,124,32.25806452,67.74193548,tract_part,http://www.prisonersofthecensus.org/data/2010blocks/470559202002018/
4.71E+14,32,1,1,0,13,1,15,63,312,375,16.8,83.2,tract_part,http://www.prisonersofthecensus.org/data/2010blocks/470590904001066/
4.71E+14,0,0,0,0,0,0,0,0,44,44,0,100,tract_part,http://www.prisonersofthecensus.org/data/2010blocks/470619550002072/
4.71E+14,32,0,1,0,0,1,16,50,227,277,18.05054152,81.94945848,tract_part,http://www.prisonersofthecensus.org/data/2010blocks/470631004004018/
4.71E+14,292,0,1,0,0,0,20,313,208,521,60.07677543,39.92322457,tract,http://www.prisonersofthecensus.org/data/2010blocks/470650031001063/
4.71E+14,21,0,0,0,0,0,1,22,32,54,40.74074074,59.25925926,tract,http://www.prisonersofthecensus.org/data/2010blocks/470650124003002/
4.71E+14,552,2,2,0,3,5,13,577,308,885,65.19774011,34.80225989,tract_part,http://www.prisonersofthecensus.org/data/2010blocks/470650113111006/
4.71E+14,1,0,0,0,0,2,0,3,98,101,2.97029703,97.02970297,tract_part,http://www.prisonersofthecensus.org/data/2010blocks/470679606002077/
4.71E+14,909,1,1,0,4,4,16,935,564,1499,62.37491661,37.62508339,institutionalized,http://www.prisonersofthecensus.org/data/2010blocks/470699502004000/
4.71E+14,1110,1,2,0,3,6,32,1154,818,1972,58.51926978,41.48073022,institutionalized,http://www.prisonersofthecensus.org/data/2010blocks/470699502004001/
4.71E+14,6,0,0,0,0,0,0,6,141,147,4.081632653,95.91836735,tract_part,http://www.prisonersofthecensus.org/data/2010blocks/470730503011058/
4.71E+14,66,0,0,0,0,0,1,67,20,87,77.01149425,22.98850575,tract_part,http://www.prisonersofthecensus.org/data/2010blocks/470759301002021/
4.71E+14,15,0,0,0,34,0,33,82,27,109,75.2293578,24.7706422,tract_part,http://www.prisonersofthecensus.org/data/2010blocks/470779753004062/
4.71E+14,39,0,0,0,0,0,1,40,126,166,24.09638554,75.90361446,tract_part,http://www.prisonersofthecensus.org/data/2010blocks/470799693004050/
4.71E+14,673,3,4,0,0,0,35,715,514,1229,58.17737998,41.82262002,tract_part,http://www.prisonersofthecensus.org/data/2010blocks/470819505001357/
4.71E+14,2,0,1,0,0,0,1,4,98,102,3.921568627,96.07843137,tract_part,http://www.prisonersofthecensus.org/data/2010blocks/470819503011023/
4.71E+14,4,0,0,0,0,0,0,4,16,20,20,80,tract_part,http://www.prisonersofthecensus.org/data/2010blocks/470831202002036/
4.71E+14,3,0,0,0,1,0,2,6,49,55,10.90909091,89.09090909,tract_part,http://www.prisonersofthecensus.org/data/2010blocks/470851303005001/
4.71E+14,4,0,0,0,0,0,1,5,75,80,6.25,93.75,tract_part,http://www.prisonersofthecensus.org/data/2010blocks/470879603003035/
4.71E+14,7,0,0,0,0,0,1,8,135,143,5.594405594,94.40559441,institutionalized,http://www.prisonersofthecensus.org/data/2010blocks/470890707003030/
4.71E+14,8,0,0,0,0,0,0,8,59,67,11.94029851,88.05970149,institutionalized,http://www.prisonersofthecensus.org/data/2010blocks/470890707003036/
4.71E+14,312,8,1,0,16,3,32,372,1192,1564,23.78516624,76.21483376,tract_part,http://www.prisonersofthecensus.org/data/2010blocks/470919561001081/
4.71E+14,1,0,0,0,1,1,1,4,111,115,3.47826087,96.52173913,tract_part,http://www.prisonersofthecensus.org/data/2010blocks/470919563002067/
4.71E+14,47,1,1,0,1,2,3,55,131,186,29.56989247,70.43010753,tract_part,http://www.prisonersofthecensus.org/data/2010blocks/470930001001098/
4.71E+14,14,0,0,0,0,0,1,15,54,69,21.73913043,78.26086957,tract_part,http://www.prisonersofthecensus.org/data/2010blocks/470930067001023/
4.71E+14,13,0,0,0,0,0,0,13,39,52,25,75,institutionalized,http://www.prisonersofthecensus.org/data/2010blocks/470930052011019/
4.71E+14,273,1,1,0,9,0,29,313,472,785,39.87261146,60.12738854,institutionalized,http://www.prisonersofthecensus.org/data/2010blocks/470930052012000/
4.71E+14,1,0,0,0,0,0,0,1,10,11,9.090909091,90.90909091,tract_part,http://www.prisonersofthecensus.org/data/2010blocks/470930056041018/
4.71E+14,1082,8,6,1,21,15,63,1196,1145,2341,51.08927809,48.91072191,tract_part,http://www.prisonersofthecensus.org/data/2010blocks/470959601003000/
4.71E+14,13,0,0,0,0,0,0,13,26,39,33.33333333,66.66666667,tract_part,http://www.prisonersofthecensus.org/data/2010blocks/470959601002008/
4.71E+14,58,2,0,0,0,1,4,65,82,147,44.21768707,55.78231293,tract_part,http://www.prisonersofthecensus.org/data/2010blocks/470970501002016/
4.71E+14,1434,18,6,1,32,33,89,1613,794,2407,67.0128791,32.9871209,tract_part,http://www.prisonersofthecensus.org/data/2010blocks/470970501002066/
4.71E+14,48,1,0,0,1,0,4,54,80,134,40.29850746,59.70149254,tract_part,http://www.prisonersofthecensus.org/data/2010blocks/470970505031007/
4.71E+14,29,1,6,0,0,0,27,63,59,122,51.63934426,48.36065574,tract_part,http://www.prisonersofthecensus.org/data/2010blocks/470999605012065/
4.71E+14,15,0,0,0,0,0,7,22,38,60,36.66666667,63.33333333,tract_part,http://www.prisonersofthecensus.org/data/2010blocks/471019702004046/
4.71E+14,28,0,0,0,0,0,1,29,71,100,29,71,tract_part,http://www.prisonersofthecensus.org/data/2010blocks/471039754002036/
4.71E+14,7,0,0,0,0,0,7,14,61,75,18.66666667,81.33333333,tract_part,http://www.prisonersofthecensus.org/data/2010blocks/471050603021014/
4.71E+14,13,0,0,0,2,2,5,22,133,155,14.19354839,85.80645161,tract_part,http://www.prisonersofthecensus.org/data/2010blocks/471079704012066/
4.71E+14,9,0,0,0,1,0,2,12,49,61,19.67213115,80.32786885,tract_part,http://www.prisonersofthecensus.org/data/2010blocks/471099305002105/
4.71E+14,5,1,0,0,3,1,6,16,90,106,15.09433962,84.90566038,tract_part,http://www.prisonersofthecensus.org/data/2010blocks/471119703001013/
4.71E+14,36,1,0,0,2,1,5,45,16,61,73.7704918,26.2295082,institutionalized,http://www.prisonersofthecensus.org/data/2010blocks/471130008002070/
4.71E+14,181,2,1,0,6,1,8,199,103,302,65.89403974,34.10596026,institutionalized,http://www.prisonersofthecensus.org/data/2010blocks/471130008002100/
4.71E+14,53,0,0,0,0,0,2,55,40,95,57.89473684,42.10526316,tract_part,http://www.prisonersofthecensus.org/data/2010blocks/471130014012072/
4.71E+14,6,0,0,0,0,0,1,7,60,67,10.44776119,89.55223881,tract_part,http://www.prisonersofthecensus.org/data/2010blocks/471150502022081/
4.71E+14,27,1,6,0,0,0,25,59,50,109,54.12844037,45.87155963,tract_part,http://www.prisonersofthecensus.org/data/2010blocks/471179552001011/
4.71E+14,0,1,0,0,0,0,1,2,11,13,15.38461538,84.61538462,tract_part,http://www.prisonersofthecensus.org/data/2010blocks/471190104001006/
4.71E+14,69,0,0,0,0,0,3,72,161,233,30.90128755,69.09871245,tract_part,http://www.prisonersofthecensus.org/data/2010blocks/471190108021027/
4.71E+14,0,0,0,0,0,0,0,0,63,63,0,100,tract_part,http://www.prisonersofthecensus.org/data/2010blocks/471219602001103/
4.71E+14,6,0,0,0,1,0,1,8,149,157,5.095541401,94.9044586,tract_part,http://www.prisonersofthecensus.org/data/2010blocks/471239254003082/
4.71E+14,148,2,2,0,3,3,17,175,125,300,58.33333333,41.66666667,tract,http://www.prisonersofthecensus.org/data/2010blocks/471251001001058/
4.71E+14,33,1,0,0,1,5,2,42,46,88,47.72727273,52.27272727,tract_part,http://www.prisonersofthecensus.org/data/2010blocks/471251004001010/
4.71E+14,6,0,0,0,0,0,0,6,16,22,27.27272727,72.72727273,tract_part,http://www.prisonersofthecensus.org/data/2010blocks/471279302002060/
4.71E+14,2,0,0,0,0,0,0,2,47,49,4.081632653,95.91836735,tract_part,http://www.prisonersofthecensus.org/data/2010blocks/471291103001026/
4.71E+14,761,3,6,0,5,2,26,803,1548,2351,34.15567843,65.84432157,tract_part,http://www.prisonersofthecensus.org/data/2010blocks/471291103003007/
4.71E+14,60,0,0,0,1,0,3,64,102,166,38.55421687,61.44578313,tract_part,http://www.prisonersofthecensus.org/data/2010blocks/471319655001012/
4.71E+14,5,1,1,0,1,4,3,15,128,143,10.48951049,89.51048951,tract_part,http://www.prisonersofthecensus.org/data/2010blocks/471339503013008/
4.71E+14,3,0,0,0,0,0,0,3,36,39,7.692307692,92.30769231,tract_part,http://www.prisonersofthecensus.org/data/2010blocks/471359302004001/
4.71E+14,0,0,0,0,0,0,1,1,8,9,11.11111111,88.88888889,tract_part,http://www.prisonersofthecensus.org/data/2010blocks/471379251003015/
4.71E+14,6,4,0,0,1,5,3,19,93,112,16.96428571,83.03571429,tract_part,http://www.prisonersofthecensus.org/data/2010blocks/471399502023087/
4.71E+14,20,0,0,0,0,0,3,23,174,197,11.6751269,88.3248731,tract_part,http://www.prisonersofthecensus.org/data/2010blocks/471410006001011/
4.71E+14,9,0,0,0,0,0,3,12,83,95,12.63157895,87.36842105,tract_part,http://www.prisonersofthecensus.org/data/2010blocks/471439754013068/
4.71E+14,6,0,0,0,0,0,0,6,94,100,6,94,tract_part,http://www.prisonersofthecensus.org/data/2010blocks/471450302023001/
4.71E+14,99,3,0,0,9,4,21,136,151,287,47.38675958,52.61324042,tract_part,http://www.prisonersofthecensus.org/data/2010blocks/471470804011027/
4.71E+14,56,2,5,0,1,3,5,72,158,230,31.30434783,68.69565217,tract_part,http://www.prisonersofthecensus.org/data/2010blocks/471490418003031/
4.71E+14,186,4,6,0,12,18,35,261,361,622,41.96141479,58.03858521,tract_part,http://www.prisonersofthecensus.org/data/2010blocks/471490418002029/
4.72E+14,0,0,0,0,0,0,1,1,103,104,0.961538462,99.03846154,tract_part,http://www.prisonersofthecensus.org/data/2010blocks/471519752004030/
4.72E+14,4,0,0,0,0,0,2,6,73,79,7.594936709,92.40506329,tract_part,http://www.prisonersofthecensus.org/data/2010blocks/471530601012055/
4.72E+14,8,2,0,1,6,8,22,47,331,378,12.43386243,87.56613757,tract_part,http://www.prisonersofthecensus.org/data/2010blocks/471550808011025/
4.72E+14,0,0,0,0,0,0,0,0,4,4,0,100,tract_part,http://www.prisonersofthecensus.org/data/2010blocks/471550801011016/
4.72E+14,675,13,6,0,212,35,359,1300,233,1533,84.80104371,15.19895629,institutionalized,http://www.prisonersofthecensus.org/data/2010blocks/471570212001010/
4.72E+14,168,4,0,0,1,0,1,174,245,419,41.5274463,58.4725537,institutionalized,http://www.prisonersofthecensus.org/data/2010blocks/471570212001017/
4.72E+14,2408,0,0,0,0,0,26,2434,384,2818,86.37331441,13.62668559,institutionalized,http://www.prisonersofthecensus.org/data/2010blocks/471570212002000/
4.72E+14,213,0,0,0,0,0,0,213,67,280,76.07142857,23.92857143,tract,http://www.prisonersofthecensus.org/data/2010blocks/471579804001016/
4.72E+14,0,0,0,0,0,0,0,0,5,5,0,100,tract,http://www.prisonersofthecensus.org/data/2010blocks/471570009003014/
4.72E+14,29,0,0,0,0,0,0,29,3,32,90.625,9.375,tract,http://www.prisonersofthecensus.org/data/2010blocks/471570037001036/
4.72E+14,2133,0,1,0,5,3,10,2152,321,2473,87.01981399,12.98018601,tract,http://www.prisonersofthecensus.org/data/2010blocks/471570114002000/
4.72E+14,18,0,0,0,1,0,1,20,9,29,68.96551724,31.03448276,tract_part,http://www.prisonersofthecensus.org/data/2010blocks/471570206321006/
4.72E+14,114,2,1,0,4,12,22,155,116,271,57.19557196,42.80442804,tract_part,http://www.prisonersofthecensus.org/data/2010blocks/471570202101000/
4.72E+14,5,0,0,0,0,2,0,7,32,39,17.94871795,82.05128205,tract_part,http://www.prisonersofthecensus.org/data/2010blocks/471599751002043/
4.72E+14,5,0,0,0,1,0,2,8,20,28,28.57142857,71.42857143,tract_part,http://www.prisonersofthecensus.org/data/2010blocks/471611107002010/
4.72E+14,0,0,0,0,0,0,0,0,1,1,0,100,tract_part,http://www.prisonersofthecensus.org/data/2010blocks/471630427015026/
4.72E+14,72,0,0,0,0,0,2,74,501,575,12.86956522,87.13043478,tract_part,http://www.prisonersofthecensus.org/data/2010blocks/471630434023023/
4.72E+14,7,0,0,0,1,0,1,9,55,64,14.0625,85.9375,tract_part,http://www.prisonersofthecensus.org/data/2010blocks/471630402002044/
4.72E+14,104,6,0,0,5,16,19,150,405,555,27.02702703,72.97297297,tract_part,http://www.prisonersofthecensus.org/data/2010blocks/471650207002058/
4.72E+14,56,0,0,0,0,2,2,60,53,113,53.09734513,46.90265487,tract_part,http://www.prisonersofthecensus.org/data/2010blocks/471670407005032/
4.72E+14,312,1,2,0,110,4,127,556,169,725,76.68965517,23.31034483,tract_part,http://www.prisonersofthecensus.org/data/2010blocks/471670410002049/
4.72E+14,5,0,0,0,0,0,0,5,21,26,19.23076923,80.76923077,tract_part,http://www.prisonersofthecensus.org/data/2010blocks/471690902002019/
4.72E+14,1,0,0,0,0,0,0,1,47,48,2.083333333,97.91666667,tract_part,http://www.prisonersofthecensus.org/data/2010blocks/471710804003024/
4.72E+14,0,0,0,0,0,0,2,2,69,71,2.816901408,97.18309859,tract_part,http://www.prisonersofthecensus.org/data/2010blocks/471730402013007/
4.72E+14,0,0,0,0,0,0,1,1,20,21,4.761904762,95.23809524,tract_part,http://www.prisonersofthecensus.org/data/2010blocks/471759252001039/
4.72E+14,11,0,0,0,0,0,18,29,225,254,11.41732283,88.58267717,tract_part,http://www.prisonersofthecensus.org/data/2010blocks/471779305004001/
4.72E+14,10,0,0,0,0,0,0,10,94,104,9.615384615,90.38461538,tract_part,http://www.prisonersofthecensus.org/data/2010blocks/471790609001009/
4.72E+14,64,0,0,0,0,0,7,71,362,433,16.39722864,83.60277136,tract_part,http://www.prisonersofthecensus.org/data/2010blocks/471790617011065/
4.72E+14,0,0,0,0,0,0,1,1,42,43,2.325581395,97.6744186,tract_part,http://www.prisonersofthecensus.org/data/2010blocks/471819502002050/
4.72E+14,863,4,6,0,0,6,76,955,945,1900,50.26315789,49.73684211,tract_part,http://www.prisonersofthecensus.org/data/2010blocks/471819501002061/
4.72E+14,19,0,1,0,0,0,0,20,49,69,28.98550725,71.01449275,tract_part,http://www.prisonersofthecensus.org/data/2010blocks/471839684005009/
4.72E+14,27,0,0,0,0,1,3,31,147,178,17.41573034,82.58426966,tract_part,http://www.prisonersofthecensus.org/data/2010blocks/471859353002032/
4.72E+14,87,0,0,0,0,0,12,99,187,286,34.61538462,65.38461538,tract_part,http://www.prisonersofthecensus.org/data/2010blocks/471870506021106/
4.72E+14,0,0,3,0,0,0,0,3,6,9,33.33333333,66.66666667,tract_part,http://www.prisonersofthecensus.org/data/2010blocks/471870508004040/
4.72E+14,60,1,0,0,0,1,3,65,169,234,27.77777778,72.22222222,tract_part,http://www.prisonersofthecensus.org/data/2010blocks/471890305001030/
4.80E+14,2110,5,21,0,1287,5,1305,4733,1643,6376,74.2314931,25.7685069,tract,http://www.prisonersofthecensus.org/data/2010blocks/480019504011001/
4.80E+14,1792,2,4,0,1003,16,1072,3889,882,4771,81.51330958,18.48669042,institutionalized,http://www.prisonersofthecensus.org/data/2010blocks/480019504021044/
4.80E+14,1436,4,4,0,433,1,438,2316,1122,3438,67.36474695,32.63525305,institutionalized,http://www.prisonersofthecensus.org/data/2010blocks/480019504021053/
4.80E+14,86,0,0,0,0,0,10,96,80,176,54.54545455,45.45454545,tract,http://www.prisonersofthecensus.org/data/2010blocks/480019507003016/
4.80E+14,379,1,1,0,197,3,202,783,551,1334,58.69565217,41.30434783,tract_part,http://www.prisonersofthecensus.org/data/2010blocks/480019509014060/
4.80E+14,176,0,1,0,184,0,184,545,157,702,77.63532764,22.36467236,tract_part,http://www.prisonersofthecensus.org/data/2010blocks/480050010013009/
4.80E+14,209,0,0,0,137,3,140,489,233,722,67.72853186,32.27146814,tract_part,http://www.prisonersofthecensus.org/data/2010blocks/480050010011079/
4.80E+14,100,0,0,0,0,0,13,113,164,277,40.79422383,59.20577617,tract_part,http://www.prisonersofthecensus.org/data/2010blocks/480050006004011/
4.80E+14,3,0,0,0,0,0,93,96,96,192,50,50,tract_part,http://www.prisonersofthecensus.org/data/2010blocks/480079503002076/
4.80E+14,0,0,0,0,0,0,1,1,9,10,10,90,tract_part,http://www.prisonersofthecensus.org/data/2010blocks/480090203004001/
4.80E+14,11,0,0,0,0,0,7,18,8,26,69.23076923,30.76923077,tract_part,http://www.prisonersofthecensus.org/data/2010blocks/480157605013024/
4.80E+14,2,0,0,0,0,0,28,30,26,56,53.57142857,46.42857143,tract_part,http://www.prisonersofthecensus.org/data/2010blocks/480179501003031/
4.80E+14,0,0,0,0,1,0,16,17,55,72,23.61111111,76.38888889,tract_part,http://www.prisonersofthecensus.org/data/2010blocks/480190001021034/
4.80E+14,48,0,0,0,0,0,152,200,100,300,66.66666667,33.33333333,tract_part,http://www.prisonersofthecensus.org/data/2010blocks/480219504004069/
4.80E+14,391,40,24,1,169,42,607,1274,434,1708,74.59016393,25.40983607,tract_part,http://www.prisonersofthecensus.org/data/2010blocks/480219505013004/
4.80E+14,8,2,1,0,7,0,87,105,26,131,80.15267176,19.84732824,tract_part,http://www.prisonersofthecensus.org/data/2010blocks/480259505006002/
4.80E+14,499,2,7,0,12,2,882,1404,831,2235,62.81879195,37.18120805,institutionalized,http://www.prisonersofthecensus.org/data/2010blocks/480259502011006/
4.80E+14,597,1,3,0,4,0,606,1211,787,1998,60.61061061,39.38938939,institutionalized,http://www.prisonersofthecensus.org/data/2010blocks/480259502011007/
4.80E+14,989,0,3,1,46,12,816,1867,1040,2907,64.22428621,35.77571379,institutionalized,http://www.prisonersofthecensus.org/data/2010blocks/480259502012001/
4.80E+14,16,0,0,0,0,0,0,16,0,16,100,0,institutionalized,http://www.prisonersofthecensus.org/data/2010blocks/480259502013035/
4.80E+14,323,3,6,0,32,14,99,477,238,715,66.71328671,33.28671329,tract_part,http://www.prisonersofthecensus.org/data/2010blocks/480270215003056/
4.80E+14,13,0,0,0,2,2,6,23,47,70,32.85714286,67.14285714,tract,http://www.prisonersofthecensus.org/data/2010blocks/480270212023004/
4.80E+14,1,0,0,0,0,1,16,18,9,27,66.66666667,33.33333333,institutionalized,http://www.prisonersofthecensus.org/data/2010blocks/480291101001026/
4.80E+14,53,19,5,4,139,19,494,733,73,806,90.94292804,9.05707196,institutionalized,http://www.prisonersofthecensus.org/data/2010blocks/480291101003080/
4.80E+14,824,0,6,1,14,5,2463,3313,847,4160,79.63942308,20.36057692,tract,http://www.prisonersofthecensus.org/data/2010blocks/480291106003012/
4.80E+14,2,0,0,0,0,0,18,20,4,24,83.33333333,16.66666667,tract,http://www.prisonersofthecensus.org/data/2010blocks/480291110002036/
4.80E+14,12,0,1,0,18,1,61,93,13,106,87.73584906,12.26415094,tract,http://www.prisonersofthecensus.org/data/2010blocks/480291411011000/
4.80E+14,1,0,0,0,0,1,15,17,3,20,85,15,remaining,http://www.prisonersofthecensus.org/data/2010blocks/480291902004006/
4.80E+14,4,2,2,0,4,0,17,29,5,34,85.29411765,14.70588235,institutionalized,http://www.prisonersofthecensus.org/data/2010blocks/480291902004023/
4.80E+14,1,0,0,0,0,0,1,2,4,6,33.33333333,66.66666667,tract,http://www.prisonersofthecensus.org/data/2010blocks/480291905041028/
4.80E+14,0,0,0,0,0,0,1,1,3,4,25,75,tract,http://www.prisonersofthecensus.org/data/2010blocks/480291909021008/
4.80E+14,21,4,0,0,49,9,148,231,33,264,87.5,12.5,tract,http://www.prisonersofthecensus.org/data/2010blocks/480291520001053/
4.80E+14,352,0,4,0,1,0,1456,1813,299,2112,85.84280303,14.15719697,tract_part,http://www.prisonersofthecensus.org/data/2010blocks/480291619023010/
4.80E+14,1,0,0,0,0,0,0,1,4,5,20,80,tract_part,http://www.prisonersofthecensus.org/data/2010blocks/480299800031088/
4.80E+14,0,0,0,0,0,0,1,1,1,2,50,50,tract_part,http://www.prisonersofthecensus.org/data/2010blocks/480319501003041/
4.80E+14,8,0,0,0,0,0,1,9,22,31,29.03225806,70.96774194,tract_part,http://www.prisonersofthecensus.org/data/2010blocks/480359502001085/
4.80E+14,1218,8,6,0,629,14,842,2717,704,3421,79.42122186,20.57877814,tract_part,http://www.prisonersofthecensus.org/data/2010blocks/480370115015000/
4.80E+14,280,0,4,0,0,1,79,364,341,705,51.63120567,48.36879433,institutionalized,http://www.prisonersofthecensus.org/data/2010blocks/480370105002128/
4.80E+14,52,0,0,0,0,0,11,63,31,94,67.0212766,32.9787234,institutionalized,http://www.prisonersofthecensus.org/data/2010blocks/480370105002129/
4.80E+14,17,0,1,0,1,0,0,19,81,100,19,81,tract_part,http://www.prisonersofthecensus.org/data/2010blocks/480370111001016/
4.80E+14,487,35,19,3,131,60,498,1233,644,1877,65.68993074,34.31006926,tract_part,http://www.prisonersofthecensus.org/data/2010blocks/480370111003038/
4.80E+14,2,0,0,0,0,0,0,2,5,7,28.57142857,71.42857143,tract,http://www.prisonersofthecensus.org/data/2010blocks/480396608011009/
4.80E+14,467,6,7,2,115,6,471,1074,672,1746,61.51202749,38.48797251,institutionalized,http://www.prisonersofthecensus.org/data/2010blocks/480396619003003/
4.80E+14,548,0,0,0,114,15,283,960,368,1328,72.28915663,27.71084337,institutionalized,http://www.prisonersofthecensus.org/data/2010blocks/480396619003052/
4.80E+14,565,4,3,1,63,8,441,1085,585,1670,64.97005988,35.02994012,institutionalized,http://www.prisonersofthecensus.org/data/2010blocks/480396619003063/
4.80E+14,995,4,2,1,161,35,563,1761,339,2100,83.85714286,16.14285714,institutionalized,http://www.prisonersofthecensus.org/data/2010blocks/480396619004007/
4.80E+14,196,0,0,0,0,0,64,260,550,810,32.09876543,67.90123457,tract_part,http://www.prisonersofthecensus.org/data/2010blocks/480396622001063/
4.80E+14,566,2,2,0,54,5,189,818,287,1105,74.02714932,25.97285068,tract_part,http://www.prisonersofthecensus.org/data/2010blocks/480396631003012/
4.80E+14,15,0,0,0,0,0,8,23,29,52,44.23076923,55.76923077,tract_part,http://www.prisonersofthecensus.org/data/2010blocks/480396620001073/
4.80E+14,445,3,8,0,68,8,438,970,192,1162,83.4767642,16.5232358,tract_part,http://www.prisonersofthecensus.org/data/2010blocks/480396630003053/
4.80E+14,0,0,0,0,0,0,1,1,2,3,33.33333333,66.66666667,tract_part,http://www.prisonersofthecensus.org/data/2010blocks/480396643004033/
4.80E+14,142,22,12,3,34,15,261,489,378,867,56.40138408,43.59861592,tract,http://www.prisonersofthecensus.org/data/2010blocks/480410004003000/
4.80E+14,172,0,0,0,14,2,76,264,102,366,72.13114754,27.86885246,tract,http://www.prisonersofthecensus.org/data/2010blocks/480410005001000/
4.80E+14,100,1,0,0,9,0,36,146,49,195,74.87179487,25.12820513,tract,http://www.prisonersofthecensus.org/data/2010blocks/480410006031046/
4.80E+14,409,6,2,0,72,7,216,712,441,1153,61.75195143,38.24804857,tract_part,http://www.prisonersofthecensus.org/data/2010blocks/480410002024055/
4.80E+14,3,0,0,0,2,0,19,24,14,38,63.15789474,36.84210526,tract_part,http://www.prisonersofthecensus.org/data/2010blocks/480439503002128/
4.80E+14,1,0,0,0,0,1,14,16,1,17,94.11764706,5.882352941,tract_part,http://www.prisonersofthecensus.org/data/2010blocks/480479502002055/
4.81E+14,148,0,1,0,1,1,146,297,137,434,68.43317972,31.56682028,tract_part,http://www.prisonersofthecensus.org/data/2010blocks/480499513002027/
4.81E+14,12,0,0,0,0,0,1,13,25,38,34.21052632,65.78947368,tract_part,http://www.prisonersofthecensus.org/data/2010blocks/480519703002034/
4.81E+14,201,2,2,0,0,1,201,407,419,826,49.27360775,50.72639225,tract_part,http://www.prisonersofthecensus.org/data/2010blocks/480539603005045/
4.81E+14,36,0,1,0,1,0,4,42,130,172,24.41860465,75.58139535,institutionalized,http://www.prisonersofthecensus.org/data/2010blocks/480559602001014/
4.81E+14,318,2,3,1,8,8,284,624,387,1011,61.72106825,38.27893175,institutionalized,http://www.prisonersofthecensus.org/data/2010blocks/480559602003007/
4.81E+14,0,0,0,0,0,0,0,0,4,4,0,100,tract_part,http://www.prisonersofthecensus.org/data/2010blocks/480559601022043/
4.81E+14,4,0,0,0,10,1,29,44,14,58,75.86206897,24.13793103,tract_part,http://www.prisonersofthecensus.org/data/2010blocks/480570002003013/
4.81E+14,1,0,0,0,0,0,1,2,3,5,40,60,tract_part,http://www.prisonersofthecensus.org/data/2010blocks/480590302001075/
4.81E+14,2,0,0,0,0,0,175,177,10,187,94.65240642,5.347593583,tract,http://www.prisonersofthecensus.org/data/2010blocks/480610138012015/
4.81E+14,112,0,96,0,35,5,567,815,32,847,96.22195986,3.778040142,tract_part,http://www.prisonersofthecensus.org/data/2010blocks/480610123011356/
4.81E+14,0,0,0,0,0,0,2,2,4,6,33.33333333,66.66666667,tract_part,http://www.prisonersofthecensus.org/data/2010blocks/480659502001076/
4.81E+14,30,0,0,0,0,0,2,32,50,82,39.02439024,60.97560976,tract_part,http://www.prisonersofthecensus.org/data/2010blocks/480679506003011/
4.81E+14,2,0,0,0,4,0,11,17,1,18,94.44444444,5.555555556,tract_part,http://www.prisonersofthecensus.org/data/2010blocks/480699502003032/
4.81E+14,35,0,0,0,7,0,31,73,63,136,53.67647059,46.32352941,tract_part,http://www.prisonersofthecensus.org/data/2010blocks/480717105001013/
4.81E+14,59,0,0,0,0,1,8,68,70,138,49.27536232,50.72463768,tract_part,http://www.prisonersofthecensus.org/data/2010blocks/480739508022089/
4.81E+14,657,0,6,0,73,7,337,1080,436,1516,71.24010554,28.75989446,tract_part,http://www.prisonersofthecensus.org/data/2010blocks/480739509002000/
4.81E+14,165,0,0,0,0,0,35,200,1,201,99.50248756,0.497512438,institutionalized,http://www.prisonersofthecensus.org/data/2010blocks/480759501001590/
4.81E+14,265,0,6,0,8,0,567,846,282,1128,75,25,institutionalized,http://www.prisonersofthecensus.org/data/2010blocks/480759501002019/
4.81E+14,7,0,0,0,0,0,14,21,13,34,61.76470588,38.23529412,tract_part,http://www.prisonersofthecensus.org/data/2010blocks/480759502001100/
4.81E+14,1,0,0,0,2,0,3,6,21,27,22.22222222,77.77777778,tract_part,http://www.prisonersofthecensus.org/data/2010blocks/480770302004077/
4.81E+14,0,0,0,0,0,0,2,2,2,4,50,50,tract_part,http://www.prisonersofthecensus.org/data/2010blocks/480799501002214/
4.81E+14,238,4,8,0,42,11,216,519,547,1066,48.68667917,51.31332083,tract_part,http://www.prisonersofthecensus.org/data/2010blocks/480850306042001/
4.81E+14,3,0,0,0,0,0,0,3,4,7,42.85714286,57.14285714,tract,http://www.prisonersofthecensus.org/data/2010blocks/480850315061015/
4.81E+14,6,0,1,0,2,2,8,19,23,42,45.23809524,54.76190476,tract_part,http://www.prisonersofthecensus.org/data/2010blocks/480850319003021/
4.81E+14,1,0,0,0,0,0,4,5,2,7,71.42857143,28.57142857,tract_part,http://www.prisonersofthecensus.org/data/2010blocks/480879503004018/
4.81E+14,26,0,0,0,0,0,16,42,20,62,67.74193548,32.25806452,tract_part,http://www.prisonersofthecensus.org/data/2010blocks/480897505003029/
4.81E+14,2,1,0,0,0,0,1,4,29,33,12.12121212,87.87878788,tract_part,http://www.prisonersofthecensus.org/data/2010blocks/480913106062000/
4.81E+14,23,0,0,0,0,0,75,98,148,246,39.83739837,60.16260163,tract_part,http://www.prisonersofthecensus.org/data/2010blocks/480913104016013/
4.81E+14,0,0,0,0,0,0,0,0,23,23,0,100,tract_part,http://www.prisonersofthecensus.org/data/2010blocks/480939503004013/
4.81E+14,59,2,9,5,103,34,1401,1613,90,1703,94.71520846,5.284791544,tract_part,http://www.prisonersofthecensus.org/data/2010blocks/480959503002264/
4.81E+14,1031,10,9,0,226,13,683,1972,1126,3098,63.6539703,36.3460297,institutionalized,http://www.prisonersofthecensus.org/data/2010blocks/480990102011002/
4.81E+14,197,3,3,0,28,4,81,316,299,615,51.38211382,48.61788618,institutionalized,http://www.prisonersofthecensus.org/data/2010blocks/480990102011013/
4.81E+14,492,7,2,0,68,7,245,821,516,1337,61.40613313,38.59386687,institutionalized,http://www.prisonersofthecensus.org/data/2010blocks/480990102011030/
4.81E+14,198,2,0,0,24,0,65,289,258,547,52.83363803,47.16636197,institutionalized,http://www.prisonersofthecensus.org/data/2010blocks/480990102011037/
4.81E+14,150,0,2,0,6,0,16,174,111,285,61.05263158,38.94736842,institutionalized,http://www.prisonersofthecensus.org/data/2010blocks/480990102011051/
4.81E+14,0,0,0,0,0,0,4,4,294,298,1.342281879,98.65771812,institutionalized,http://www.prisonersofthecensus.org/data/2010blocks/480990102012001/
4.81E+14,93,0,0,0,40,1,158,292,228,520,56.15384615,43.84615385,institutionalized,http://www.prisonersofthecensus.org/data/2010blocks/480990102012003/
4.81E+14,92,5,2,0,0,1,4,104,66,170,61.17647059,38.82352941,institutionalized,http://www.prisonersofthecensus.org/data/2010blocks/480990102012005/
4.81E+14,80,0,0,0,0,0,2,82,134,216,37.96296296,62.03703704,institutionalized,http://www.prisonersofthecensus.org/data/2010blocks/480990102012006/
4.81E+14,241,1,3,0,29,6,78,358,530,888,40.31531532,59.68468468,institutionalized,http://www.prisonersofthecensus.org/data/2010blocks/480990102012013/
4.81E+14,1,2,0,0,28,0,66,97,0,97,100,0,institutionalized,http://www.prisonersofthecensus.org/data/2010blocks/480990103001019/
4.81E+14,223,1,0,0,26,0,85,335,132,467,71.73447537,28.26552463,institutionalized,http://www.prisonersofthecensus.org/data/2010blocks/480990103001023/
4.81E+14,24,0,1,0,0,0,8,33,51,84,39.28571429,60.71428571,institutionalized,http://www.prisonersofthecensus.org/data/2010blocks/480990103001051/
4.81E+14,3,0,0,0,0,0,9,12,8,20,60,40,tract_part,http://www.prisonersofthecensus.org/data/2010blocks/481039501002000/
4.81E+14,1,0,0,0,0,0,6,7,1,8,87.5,12.5,tract_part,http://www.prisonersofthecensus.org/data/2010blocks/481079501003024/
4.81E+14,0,0,0,0,1,4,8,13,2,15,86.66666667,13.33333333,tract_part,http://www.prisonersofthecensus.org/data/2010blocks/481099503004201/
4.81E+14,1,0,0,0,24,0,25,50,12,62,80.64516129,19.35483871,tract_part,http://www.prisonersofthecensus.org/data/2010blocks/481119503002007/
4.81E+14,9,0,0,0,0,0,3,12,2,14,85.71428571,14.28571429,tract,http://www.prisonersofthecensus.org/data/2010blocks/481130031012039/
4.81E+14,3237,0,24,0,17,6,1206,4490,1899,6389,70.27703866,29.72296134,institutionalized,http://www.prisonersofthecensus.org/data/2010blocks/481130100001208/
4.81E+14,1,0,0,0,0,0,0,1,0,1,100,0,institutionalized,http://www.prisonersofthecensus.org/data/2010blocks/481130100001209/
4.81E+14,920,5,6,0,1,2,385,1319,896,2215,59.54853273,40.45146727,institutionalized,http://www.prisonersofthecensus.org/data/2010blocks/481130100001226/
4.81E+14,0,0,0,0,0,0,0,0,5,5,0,100,tract,http://www.prisonersofthecensus.org/data/2010blocks/481130190192008/
4.81E+14,0,0,0,0,0,0,0,0,2,2,0,100,tract,http://www.prisonersofthecensus.org/data/2010blocks/481130203002013/
4.81E+14,2,0,1,0,0,0,9,12,4,16,75,25,tract,http://www.prisonersofthecensus.org/data/2010blocks/481130191002018/
4.81E+14,1,0,0,0,0,0,0,1,0,1,100,0,tract_part,http://www.prisonersofthecensus.org/data/2010blocks/481130181331027/
4.81E+14,388,67,26,2,139,40,471,1133,825,1958,57.86516854,42.13483146,institutionalized,http://www.prisonersofthecensus.org/data/2010blocks/481130170012009/
4.81E+14,68,1,3,0,43,10,129,254,52,306,83.00653595,16.99346405,institutionalized,http://www.prisonersofthecensus.org/data/2010blocks/481130170012010/
4.81E+14,883,9,10,1,123,23,483,1532,663,2195,69.79498861,30.20501139,institutionalized,http://www.prisonersofthecensus.org/data/2010blocks/481130169021016/
4.81E+14,59,1,0,0,0,1,30,91,51,142,64.08450704,35.91549296,institutionalized,http://www.prisonersofthecensus.org/data/2010blocks/481130169022011/
4.81E+14,134,5,1,0,43,7,66,256,141,397,64.4836272,35.5163728,tract_part,http://www.prisonersofthecensus.org/data/2010blocks/481130169033012/
4.81E+14,441,14,7,1,518,35,883,1899,705,2604,72.92626728,27.07373272,tract_part,http://www.prisonersofthecensus.org/data/2010blocks/481159504021008/
4.81E+14,3,0,1,0,1,0,64,69,10,79,87.34177215,12.65822785,tract_part,http://www.prisonersofthecensus.org/data/2010blocks/481179505003046/
4.81E+14,258,0,2,0,8,4,302,574,572,1146,50.08726003,49.91273997,institutionalized,http://www.prisonersofthecensus.org/data/2010blocks/481210212023002/
4.81E+14,6,0,0,0,0,0,2,8,9,17,47.05882353,52.94117647,institutionalized,http://www.prisonersofthecensus.org/data/2010blocks/481210212023010/
4.81E+14,0,0,0,0,0,0,2,2,9,11,18.18181818,81.81818182,tract_part,http://www.prisonersofthecensus.org/data/2010blocks/481210217423005/
4.81E+14,0,0,0,0,0,0,0,0,1,1,0,100,tract_part,http://www.prisonersofthecensus.org/data/2010blocks/481210215133024/
4.81E+14,5,0,0,0,0,0,5,10,10,20,50,50,tract,http://www.prisonersofthecensus.org/data/2010blocks/481210217163010/
4.81E+14,14,0,0,0,10,1,29,54,20,74,72.97297297,27.02702703,tract_part,http://www.prisonersofthecensus.org/data/2010blocks/481239703003044/
4.81E+14,360,2,0,0,633,0,633,1628,330,1958,83.14606742,16.85393258,tract_part,http://www.prisonersofthecensus.org/data/2010blocks/481239702002018/
4.81E+14,2,0,0,0,0,0,1,3,2,5,60,40,tract_part,http://www.prisonersofthecensus.org/data/2010blocks/481259503001910/
4.81E+14,69,0,1,0,0,0,167,237,74,311,76.20578778,23.79421222,tract_part,http://www.prisonersofthecensus.org/data/2010blocks/481259503003076/
4.81E+14,0,0,0,0,0,0,29,29,0,29,100,0,tract_part,http://www.prisonersofthecensus.org/data/2010blocks/481279502001239/
4.81E+14,3,0,0,0,1,0,2,6,4,10,60,40,tract_part,http://www.prisonersofthecensus.org/data/2010blocks/481299502002028/
4.81E+14,79,9,0,0,44,18,324,474,112,586,80.88737201,19.11262799,tract_part,http://www.prisonersofthecensus.org/data/2010blocks/481319501005349/
4.81E+14,5,0,0,0,0,0,8,13,38,51,25.49019608,74.50980392,tract_part,http://www.prisonersofthecensus.org/data/2010blocks/481339502002023/
4.81E+14,1,1,0,0,9,2,15,28,13,41,68.29268293,31.70731707,tract,http://www.prisonersofthecensus.org/data/2010blocks/481350016003030/
4.81E+14,0,0,0,0,0,0,3,3,5,8,37.5,62.5,tract,http://www.prisonersofthecensus.org/data/2010blocks/481350017005014/
4.81E+14,96,1,0,0,0,0,222,319,214,533,59.84990619,40.15009381,tract_part,http://www.prisonersofthecensus.org/data/2010blocks/481350030004076/
4.81E+14,44,0,0,0,0,0,105,149,64,213,69.95305164,30.04694836,institutionalized,http://www.prisonersofthecensus.org/data/2010blocks/481350031001059/
4.81E+14,5,0,0,0,0,0,16,21,3,24,87.5,12.5,institutionalized,http://www.prisonersofthecensus.org/data/2010blocks/481350031001079/
4.81E+14,0,1,0,0,0,1,4,6,0,6,100,0,tract_part,http://www.prisonersofthecensus.org/data/2010blocks/481379503001069/
4.81E+14,80,0,0,0,0,0,63,143,164,307,46.57980456,53.42019544,tract_part,http://www.prisonersofthecensus.org/data/2010blocks/481390604001016/
4.81E+14,54,0,38,0,2,5,834,933,32,965,96.68393782,3.316062176,institutionalized,http://www.prisonersofthecensus.org/data/2010blocks/481410034022003/
4.81E+14,2,0,0,0,0,4,33,39,6,45,86.66666667,13.33333333,institutionalized,http://www.prisonersofthecensus.org/data/2010blocks/481410034022108/
4.81E+14,0,0,0,0,0,0,9,9,0,9,100,0,tract,http://www.prisonersofthecensus.org/data/2010blocks/481410036012002/
4.81E+14,4,0,2,0,0,0,89,95,43,138,68.84057971,31.15942029,tract,http://www.prisonersofthecensus.org/data/2010blocks/481410036021022/
4.81E+14,289,0,4,0,0,0,517,810,278,1088,74.44852941,25.55147059,institutionalized,http://www.prisonersofthecensus.org/data/2010blocks/481410103393002/
4.81E+14,129,5,2,0,0,3,1642,1781,151,1932,92.18426501,7.81573499,institutionalized,http://www.prisonersofthecensus.org/data/2010blocks/481410103393005/
4.81E+14,106,1,0,0,2,1,176,286,145,431,66.35730858,33.64269142,tract_part,http://www.prisonersofthecensus.org/data/2010blocks/481410103321009/
4.81E+14,373,96,38,10,115,58,580,1270,541,1811,70.12700166,29.87299834,institutionalized,http://www.prisonersofthecensus.org/data/2010blocks/481410102031009/
4.81E+14,36,3,5,1,12,44,165,266,82,348,76.43678161,23.56321839,institutionalized,http://www.prisonersofthecensus.org/data/2010blocks/481410102032106/
4.81E+14,2,0,0,0,5,0,5,12,41,53,22.64150943,77.35849057,tract_part,http://www.prisonersofthecensus.org/data/2010blocks/481439506001037/
4.81E+14,211,0,2,0,168,5,219,605,159,764,79.18848168,20.81151832,tract_part,http://www.prisonersofthecensus.org/data/2010blocks/481450004002027/
4.81E+14,545,0,4,0,184,3,286,1022,489,1511,67.63732627,32.36267373,tract_part,http://www.prisonersofthecensus.org/data/2010blocks/481450008002143/
4.81E+14,2,0,0,0,0,0,0,2,5,7,28.57142857,71.42857143,tract_part,http://www.prisonersofthecensus.org/data/2010blocks/481450008003059/
4.81E+14,739,7,14,0,411,11,512,1694,765,2459,68.8897926,31.1102074,tract_part,http://www.prisonersofthecensus.org/data/2010blocks/481479504013001/
4.81E+14,76,0,0,0,0,2,134,212,135,347,61.09510086,38.90489914,tract_part,http://www.prisonersofthecensus.org/data/2010blocks/481479504022052/
4.82E+14,11,0,0,0,0,0,3,14,6,20,70,30,tract_part,http://www.prisonersofthecensus.org/data/2010blocks/481499703001018/
4.82E+14,2,0,0,0,0,0,2,4,6,10,40,60,tract_part,http://www.prisonersofthecensus.org/data/2010blocks/481519503001085/
4.82E+14,492,0,21,0,1,1,33,548,449,997,54.96489468,45.03510532,tract_part,http://www.prisonersofthecensus.org/data/2010blocks/481576747003016/
4.82E+14,91,1,3,0,1,0,60,156,263,419,37.23150358,62.76849642,tract_part,http://www.prisonersofthecensus.org/data/2010blocks/481576749003023/
4.82E+14,390,2,4,0,57,13,288,754,246,1000,75.4,24.6,tract_part,http://www.prisonersofthecensus.org/data/2010blocks/481576728001046/
4.82E+14,77,3,0,0,15,2,77,174,141,315,55.23809524,44.76190476,institutionalized,http://www.prisonersofthecensus.org/data/2010blocks/481576737001016/
4.82E+14,206,0,3,0,0,0,116,325,155,480,67.70833333,32.29166667,institutionalized,http://www.prisonersofthecensus.org/data/2010blocks/481576737001030/
4.82E+14,142,1,1,0,6,2,40,192,88,280,68.57142857,31.42857143,institutionalized,http://www.prisonersofthecensus.org/data/2010blocks/481576737001031/
4.82E+14,413,2,5,0,25,7,269,721,405,1126,64.03197158,35.96802842,institutionalized,http://www.prisonersofthecensus.org/data/2010blocks/481576737001032/
4.82E+14,7,0,0,0,0,0,3,10,19,29,34.48275862,65.51724138,tract_part,http://www.prisonersofthecensus.org/data/2010blocks/481599502001050/
4.82E+14,9,0,0,0,1,0,5,15,13,28,53.57142857,46.42857143,tract_part,http://www.prisonersofthecensus.org/data/2010blocks/481610002001036/
4.82E+14,419,1,0,0,365,1,371,1157,536,1693,68.34022445,31.65977555,tract_part,http://www.prisonersofthecensus.org/data/2010blocks/481610006003015/
4.82E+14,439,8,36,0,147,30,627,1287,144,1431,89.93710692,10.06289308,tract_part,http://www.prisonersofthecensus.org/data/2010blocks/481639503004000/
4.82E+14,24,1,0,0,0,7,321,353,30,383,92.16710183,7.832898172,tract_part,http://www.prisonersofthecensus.org/data/2010blocks/481639501004023/
4.82E+14,63,3,279,0,253,39,1173,1810,22,1832,98.79912664,1.200873362,tract_part,http://www.prisonersofthecensus.org/data/2010blocks/481639502002145/
4.82E+14,0,0,0,0,0,0,9,9,11,20,45,55,tract_part,http://www.prisonersofthecensus.org/data/2010blocks/481659503001049/
4.82E+14,405,4,3,0,50,19,157,638,429,1067,59.79381443,40.20618557,tract,http://www.prisonersofthecensus.org/data/2010blocks/481677240002066/
4.82E+14,79,1,0,0,28,0,43,151,51,202,74.75247525,25.24752475,tract,http://www.prisonersofthecensus.org/data/2010blocks/481677243001002/
4.82E+14,10,0,0,0,1,0,7,18,5,23,78.26086957,21.73913043,tract_part,http://www.prisonersofthecensus.org/data/2010blocks/481677209003051/
4.82E+14,151,2,1,0,29,4,84,271,182,453,59.82339956,40.17660044,tract_part,http://www.prisonersofthecensus.org/data/2010blocks/481677219001108/
4.82E+14,171,0,0,0,1,6,1356,1534,468,2002,76.62337662,23.37662338,tract_part,http://www.prisonersofthecensus.org/data/2010blocks/481699501002013/
4.82E+14,0,0,0,0,0,0,0,0,6,6,0,100,tract_part,http://www.prisonersofthecensus.org/data/2010blocks/481719503001046/
4.82E+14,10,1,0,0,5,0,8,24,12,36,66.66666667,33.33333333,tract_part,http://www.prisonersofthecensus.org/data/2010blocks/481759601003035/
4.82E+14,15,0,0,0,9,4,15,43,29,72,59.72222222,40.27777778,tract_part,http://www.prisonersofthecensus.org/data/2010blocks/481770002003114/
4.82E+14,10,0,0,0,26,0,26,62,22,84,73.80952381,26.19047619,tract_part,http://www.prisonersofthecensus.org/data/2010blocks/481770002003119/
4.82E+14,482,0,3,0,0,7,436,928,448,1376,67.44186047,32.55813953,tract_part,http://www.prisonersofthecensus.org/data/2010blocks/481799501001063/
4.82E+14,11,1,0,0,2,0,16,30,46,76,39.47368421,60.52631579,tract_part,http://www.prisonersofthecensus.org/data/2010blocks/481799507002021/
4.82E+14,52,0,2,0,28,0,28,110,142,252,43.65079365,56.34920635,tract_part,http://www.prisonersofthecensus.org/data/2010blocks/481810020003107/
4.82E+14,8,2,0,0,4,1,7,22,38,60,36.66666667,63.33333333,tract_part,http://www.prisonersofthecensus.org/data/2010blocks/481830102006073/
4.82E+14,16,1,0,0,0,0,0,17,22,39,43.58974359,56.41025641,tract_part,http://www.prisonersofthecensus.org/data/2010blocks/481830104005071/
4.82E+14,192,0,0,0,7,0,24,223,318,541,41.21996303,58.78003697,institutionalized,http://www.prisonersofthecensus.org/data/2010blocks/481830011001016/
4.82E+14,94,2,0,0,0,0,6,102,72,174,58.62068966,41.37931034,institutionalized,http://www.prisonersofthecensus.org/data/2010blocks/481830011001048/
4.82E+14,458,7,3,0,90,7,303,868,679,1547,56.10859729,43.89140271,institutionalized,http://www.prisonersofthecensus.org/data/2010blocks/481851804001001/
4.82E+14,486,4,2,0,81,6,288,867,515,1382,62.73516643,37.26483357,institutionalized,http://www.prisonersofthecensus.org/data/2010blocks/481851804001022/
4.82E+14,68,0,1,0,0,0,266,335,130,465,72.04301075,27.95698925,tract_part,http://www.prisonersofthecensus.org/data/2010blocks/481872105041020/
4.82E+14,9,0,0,0,0,0,98,107,54,161,66.45962733,33.54037267,tract_part,http://www.prisonersofthecensus.org/data/2010blocks/481899502002011/
4.82E+14,498,6,10,0,79,7,763,1363,664,2027,67.2422299,32.7577701,tract_part,http://www.prisonersofthecensus.org/data/2010blocks/481899506001216/
4.82E+14,0,0,0,0,0,0,4,4,2,6,66.66666667,33.33333333,tract_part,http://www.prisonersofthecensus.org/data/2010blocks/481919505001088/
4.82E+14,7,0,0,0,0,0,0,7,10,17,41.17647059,58.82352941,tract_part,http://www.prisonersofthecensus.org/data/2010blocks/481939503003079/
4.82E+14,0,0,0,0,2,0,2,4,1,5,80,20,tract_part,http://www.prisonersofthecensus.org/data/2010blocks/481959503001231/
4.82E+14,2,0,0,0,0,0,1,3,3,6,50,50,tract_part,http://www.prisonersofthecensus.org/data/2010blocks/481979501002161/
4.82E+14,1034,0,12,1,102,29,611,1789,444,2233,80.11643529,19.88356471,institutionalized,http://www.prisonersofthecensus.org/data/2010blocks/482012503011025/
4.82E+14,165,1,1,1,23,1,75,267,87,354,75.42372881,24.57627119,institutionalized,http://www.prisonersofthecensus.org/data/2010blocks/482012503011044/
4.82E+14,2,0,0,0,0,0,0,2,1,3,66.66666667,33.33333333,tract,http://www.prisonersofthecensus.org/data/2010blocks/482014209001029/
4.82E+14,9,0,0,0,510,0,619,1138,10,1148,99.12891986,0.871080139,institutionalized,http://www.prisonersofthecensus.org/data/2010blocks/482011000001029/
4.82E+14,206,1,0,0,91,3,103,404,135,539,74.95361781,25.04638219,institutionalized,http://www.prisonersofthecensus.org/data/2010blocks/482011000001045/
4.82E+14,4581,1,54,0,15,32,1658,6341,2747,9088,69.77332746,30.22667254,institutionalized,http://www.prisonersofthecensus.org/data/2010blocks/482012101001042/
4.82E+14,315,0,1,0,86,25,111,538,81,619,86.91437803,13.08562197,institutionalized,http://www.prisonersofthecensus.org/data/2010blocks/482012101001043/
4.82E+14,1,0,0,0,2,0,6,9,1,10,90,10,tract,http://www.prisonersofthecensus.org/data/2010blocks/482012304001010/
4.82E+14,6,0,4,0,0,1,0,11,1,12,91.66666667,8.333333333,tract,http://www.prisonersofthecensus.org/data/2010blocks/482012306002007/
4.82E+14,238,0,0,1,6,1,78,324,174,498,65.06024096,34.93975904,tract,http://www.prisonersofthecensus.org/data/2010blocks/482012325001003/
4.82E+14,182,2,36,0,109,21,361,711,261,972,73.14814815,26.85185185,tract_part,http://www.prisonersofthecensus.org/data/2010blocks/482012415003107/
4.82E+14,1,0,0,0,0,0,1,2,3,5,40,60,tract,http://www.prisonersofthecensus.org/data/2010blocks/482014133002014/
4.82E+14,47,1,5,0,5,2,16,76,85,161,47.20496894,52.79503106,tract,http://www.prisonersofthecensus.org/data/2010blocks/482014536022010/
4.82E+14,141,0,6,0,0,0,87,234,43,277,84.4765343,15.5234657,tract,http://www.prisonersofthecensus.org/data/2010blocks/482015101001061/
4.82E+14,54,2,0,0,7,4,12,79,41,120,65.83333333,34.16666667,tract,http://www.prisonersofthecensus.org/data/2010blocks/482015306001013/
4.82E+14,0,0,0,0,0,1,0,1,12,13,7.692307692,92.30769231,tract,http://www.prisonersofthecensus.org/data/2010blocks/482015432001083/
4.82E+14,0,0,0,0,0,0,4,4,0,4,100,0,tract,http://www.prisonersofthecensus.org/data/2010blocks/482013208002024/
4.82E+14,1,0,0,0,0,0,13,14,13,27,51.85185185,48.14814815,tract,http://www.prisonersofthecensus.org/data/2010blocks/482013230001038/
4.82E+14,13,0,0,0,0,0,1,14,42,56,25,75,tract_part,http://www.prisonersofthecensus.org/data/2010blocks/482030203011006/
4.82E+14,45,0,0,0,0,0,14,59,79,138,42.75362319,57.24637681,tract_part,http://www.prisonersofthecensus.org/data/2010blocks/482030204021001/
4.82E+14,398,1,5,0,0,0,514,918,416,1334,68.8155922,31.1844078,tract_part,http://www.prisonersofthecensus.org/data/2010blocks/482059502001099/
4.82E+14,61,4,21,0,2,5,124,217,276,493,44.01622718,55.98377282,tract_part,http://www.prisonersofthecensus.org/data/2010blocks/482079503002000/
4.82E+14,174,0,0,0,2,0,110,286,103,389,73.5218509,26.4781491,tract_part,http://www.prisonersofthecensus.org/data/2010blocks/482090109062005/
4.82E+14,27,0,0,0,0,1,140,168,91,259,64.86486486,35.13513514,tract_part,http://www.prisonersofthecensus.org/data/2010blocks/482090103032035/
4.82E+14,0,0,0,0,0,0,2,2,2,4,50,50,tract_part,http://www.prisonersofthecensus.org/data/2010blocks/482119503002074/
4.82E+14,77,1,0,0,0,0,29,107,259,366,29.23497268,70.76502732,tract_part,http://www.prisonersofthecensus.org/data/2010blocks/482139513004099/
4.82E+14,1,0,0,0,2,0,773,776,10,786,98.72773537,1.272264631,tract_part,http://www.prisonersofthecensus.org/data/2010blocks/482150246002075/
4.82E+14,560,0,9,0,2,1,1387,1959,561,2520,77.73809524,22.26190476,tract_part,http://www.prisonersofthecensus.org/data/2010blocks/482150235121024/
4.82E+14,1,0,1,0,4,0,28,34,7,41,82.92682927,17.07317073,tract_part,http://www.prisonersofthecensus.org/data/2010blocks/482150236005031/
4.82E+14,2,0,1,0,12,0,114,129,2,131,98.47328244,1.526717557,tract,http://www.prisonersofthecensus.org/data/2010blocks/482150240002000/
4.82E+14,2,0,0,0,0,0,6,8,17,25,32,68,institutionalized,http://www.prisonersofthecensus.org/data/2010blocks/482179609001012/
4.82E+14,31,0,0,0,0,0,18,49,65,114,42.98245614,57.01754386,institutionalized,http://www.prisonersofthecensus.org/data/2010blocks/482179609001048/
4.82E+14,5,0,0,0,0,0,32,37,17,54,68.51851852,31.48148148,tract_part,http://www.prisonersofthecensus.org/data/2010blocks/482199505002015/
4.82E+14,1,0,0,0,0,1,4,6,0,6,100,0,tract_part,http://www.prisonersofthecensus.org/data/2010blocks/482199503001049/
4.82E+14,5,0,1,0,0,0,19,25,160,185,13.51351351,86.48648649,tract_part,http://www.prisonersofthecensus.org/data/2010blocks/482211601004025/
4.82E+14,12,0,0,0,0,0,9,21,56,77,27.27272727,72.72727273,tract_part,http://www.prisonersofthecensus.org/data/2010blocks/482239505002011/
4.82E+14,34,0,1,0,2,0,6,43,29,72,59.72222222,40.27777778,tract,http://www.prisonersofthecensus.org/data/2010blocks/482259503003026/
4.82E+14,1106,2,2,0,378,12,556,2056,775,2831,72.62451431,27.37548569,tract_part,http://www.prisonersofthecensus.org/data/2010blocks/482259507001018/
4.82E+14,61,4,8,0,162,0,179,414,128,542,76.38376384,23.61623616,tract_part,http://www.prisonersofthecensus.org/data/2010blocks/482279503001023/
4.82E+14,2,0,0,0,3,0,19,24,46,70,34.28571429,65.71428571,institutionalized,http://www.prisonersofthecensus.org/data/2010blocks/482279508021010/
4.82E+14,235,21,32,0,618,0,704,1610,473,2083,77.29236678,22.70763322,institutionalized,http://www.prisonersofthecensus.org/data/2010blocks/482279508022001/
4.82E+14,181,12,21,0,486,0,527,1227,329,1556,78.85604113,21.14395887,institutionalized,http://www.prisonersofthecensus.org/data/2010blocks/482279508022013/
4.82E+14,94,9,12,0,233,0,263,611,184,795,76.85534591,23.14465409,institutionalized,http://www.prisonersofthecensus.org/data/2010blocks/482279508022020/
4.82E+14,347,4,10,1,406,0,484,1252,872,2124,58.94538606,41.05461394,institutionalized,http://www.prisonersofthecensus.org/data/2010blocks/482279508022024/
4.82E+14,5,0,3,0,0,0,72,80,6,86,93.02325581,6.976744186,tract_part,http://www.prisonersofthecensus.org/data/2010blocks/482299503001462/
4.82E+14,8,0,0,0,0,0,1,9,1,10,90,10,tract_part,http://www.prisonersofthecensus.org/data/2010blocks/482319608001060/
4.82E+14,68,1,2,1,0,6,30,108,154,262,41.22137405,58.77862595,tract_part,http://www.prisonersofthecensus.org/data/2010blocks/482319610001021/
4.82E+14,1,0,0,0,0,0,0,1,1,2,50,50,tract_part,http://www.prisonersofthecensus.org/data/2010blocks/482339507002038/
4.82E+14,18,1,1,0,2,2,23,47,47,94,50,50,tract_part,http://www.prisonersofthecensus.org/data/2010blocks/482339502001101/
4.82E+14,262,1,4,0,252,0,266,785,563,1348,58.23442136,41.76557864,tract_part,http://www.prisonersofthecensus.org/data/2010blocks/482379501001489/
4.82E+14,15,0,0,0,0,0,20,35,27,62,56.4516129,43.5483871,tract_part,http://www.prisonersofthecensus.org/data/2010blocks/482399503001074/
4.82E+14,25,0,0,0,1,0,1,27,42,69,39.13043478,60.86956522,tract_part,http://www.prisonersofthecensus.org/data/2010blocks/482419502004017/
4.82E+14,182,0,6,0,208,1,209,606,197,803,75.46699875,24.53300125,tract_part,http://www.prisonersofthecensus.org/data/2010blocks/482419504003027/
4.82E+14,37,1,1,0,48,0,48,135,88,223,60.53811659,39.46188341,tract,http://www.prisonersofthecensus.org/data/2010blocks/482450009002028/
4.82E+14,519,0,0,0,157,1,158,835,351,1186,70.40472175,29.59527825,tract_part,http://www.prisonersofthecensus.org/data/2010blocks/482450113041046/
4.82E+14,1162,36,20,0,159,45,933,2355,645,3000,78.5,21.5,institutionalized,http://www.prisonersofthecensus.org/data/2010blocks/482450113021000/
4.82E+14,719,26,20,6,164,60,720,1715,503,2218,77.32191163,22.67808837,institutionalized,http://www.prisonersofthecensus.org/data/2010blocks/482450113021002/
4.82E+14,675,0,11,0,542,2,545,1775,557,2332,76.11492281,23.88507719,tract_part,http://www.prisonersofthecensus.org/data/2010blocks/482450113041047/
4.82E+14,567,6,8,0,16,12,58,667,229,896,74.44196429,25.55803571,tract_part,http://www.prisonersofthecensus.org/data/2010blocks/482450112011089/
4.82E+14,1257,3,20,0,782,18,940,3020,1010,4030,74.93796526,25.06203474,tract,http://www.prisonersofthecensus.org/data/2010blocks/482450112021000/
4.82E+14,0,0,0,0,4,1,16,21,0,21,100,0,tract_part,http://www.prisonersofthecensus.org/data/2010blocks/482479504002068/
4.83E+14,0,5,0,0,16,5,53,79,9,88,89.77272727,10.22727273,tract_part,http://www.prisonersofthecensus.org/data/2010blocks/482499504001027/
4.83E+14,318,2,1,0,5,1,448,775,269,1044,74.23371648,25.76628352,tract_part,http://www.prisonersofthecensus.org/data/2010blocks/482511304084016/
4.83E+14,61,5,1,0,67,12,167,313,241,554,56.49819495,43.50180505,tract_part,http://www.prisonersofthecensus.org/data/2010blocks/482511308001013/
4.83E+14,2,0,0,0,0,0,7,9,8,17,52.94117647,47.05882353,tract_part,http://www.prisonersofthecensus.org/data/2010blocks/482530202001037/
4.83E+14,1717,0,12,0,1451,3,1475,4658,1186,5844,79.70568104,20.29431896,tract_part,http://www.prisonersofthecensus.org/data/2010blocks/482530201021004/
4.83E+14,34,0,0,0,230,1,230,495,133,628,78.82165605,21.17834395,tract_part,http://www.prisonersofthecensus.org/data/2010blocks/482530201012138/
4.83E+14,0,0,0,0,0,1,1,2,0,2,100,0,institutionalized,http://www.prisonersofthecensus.org/data/2010blocks/482559702001122/
4.83E+14,16,0,0,0,280,2,283,581,11,592,98.14189189,1.858108108,remaining,http://www.prisonersofthecensus.org/data/2010blocks/482559702002011/
4.83E+14,1117,1,5,0,1135,1,1193,3452,526,3978,86.77727501,13.22272499,tract_part,http://www.prisonersofthecensus.org/data/2010blocks/482559703004056/
4.83E+14,55,0,0,0,0,0,40,95,160,255,37.25490196,62.74509804,tract_part,http://www.prisonersofthecensus.org/data/2010blocks/482570512012013/
4.83E+14,1,1,0,0,0,0,12,14,17,31,45.16129032,54.83870968,tract_part,http://www.prisonersofthecensus.org/data/2010blocks/482599704024011/
4.83E+14,0,0,0,0,1,0,3,4,11,15,26.66666667,73.33333333,institutionalized,http://www.prisonersofthecensus.org/data/2010blocks/482659606002007/
4.83E+14,17,2,0,0,21,1,51,92,88,180,51.11111111,48.88888889,institutionalized,http://www.prisonersofthecensus.org/data/2010blocks/482659606005015/
4.83E+14,0,0,0,0,0,0,2,2,8,10,20,80,tract_part,http://www.prisonersofthecensus.org/data/2010blocks/482679502001042/
4.83E+14,1,0,0,0,5,0,25,31,0,31,100,0,tract_part,http://www.prisonersofthecensus.org/data/2010blocks/482719501002165/
4.83E+14,2,0,0,0,2,2,302,308,5,313,98.40255591,1.597444089,tract_part,http://www.prisonersofthecensus.org/data/2010blocks/482719501001505/
4.83E+14,13,0,0,0,0,2,87,102,20,122,83.60655738,16.39344262,tract_part,http://www.prisonersofthecensus.org/data/2010blocks/482730202004010/
4.83E+14,3,0,0,0,0,0,4,7,4,11,63.63636364,36.36363636,tract_part,http://www.prisonersofthecensus.org/data/2010blocks/482759501002363/
4.83E+14,49,1,0,0,0,0,7,57,91,148,38.51351351,61.48648649,tract_part,http://www.prisonersofthecensus.org/data/2010blocks/482770008002031/
4.83E+14,7,0,0,0,0,0,28,35,5,40,87.5,12.5,tract_part,http://www.prisonersofthecensus.org/data/2010blocks/482799506002010/
4.83E+14,1,0,0,0,0,0,5,6,20,26,23.07692308,76.92307692,tract_part,http://www.prisonersofthecensus.org/data/2010blocks/482819505002046/
4.83E+14,0,0,0,0,1,0,8,9,0,9,100,0,tract_part,http://www.prisonersofthecensus.org/data/2010blocks/482839503005002/
4.83E+14,0,9,0,0,0,1,561,571,9,580,98.44827586,1.551724138,tract_part,http://www.prisonersofthecensus.org/data/2010blocks/482839503001353/
4.83E+14,0,7,0,0,0,1,979,987,8,995,99.1959799,0.804020101,tract_part,http://www.prisonersofthecensus.org/data/2010blocks/482839503002252/
4.83E+14,16,0,0,0,3,0,8,27,14,41,65.85365854,34.14634146,tract_part,http://www.prisonersofthecensus.org/data/2010blocks/482850002001123/
4.83E+14,16,0,0,0,0,0,6,22,16,38,57.89473684,42.10526316,tract_part,http://www.prisonersofthecensus.org/data/2010blocks/482870004002075/
4.83E+14,9,0,0,0,2,0,3,14,15,29,48.27586207,51.72413793,tract_part,http://www.prisonersofthecensus.org/data/2010blocks/482899503002108/
4.83E+14,164,2,10,0,40,3,188,407,164,571,71.27845884,28.72154116,tract_part,http://www.prisonersofthecensus.org/data/2010blocks/482917002001006/
4.83E+14,111,2,0,0,34,5,60,212,167,379,55.93667546,44.06332454,tract_part,http://www.prisonersofthecensus.org/data/2010blocks/482917014001019/
4.83E+14,1329,15,14,1,493,31,1119,3002,1490,4492,66.82991986,33.17008014,tract_part,http://www.prisonersofthecensus.org/data/2010blocks/482917009003002/
4.83E+14,35,0,0,0,0,0,15,50,56,106,47.16981132,52.83018868,institutionalized,http://www.prisonersofthecensus.org/data/2010blocks/482939706003201/
4.83E+14,162,4,4,0,68,9,199,446,387,833,53.54141657,46.45858343,remaining,http://www.prisonersofthecensus.org/data/2010blocks/482939706004000/
4.83E+14,134,0,3,0,6,2,43,188,262,450,41.77777778,58.22222222,tract_part,http://www.prisonersofthecensus.org/data/2010blocks/482939704002032/
4.83E+14,0,0,0,0,0,0,1,1,3,4,25,75,tract_part,http://www.prisonersofthecensus.org/data/2010blocks/482959503001233/
4.83E+14,0,0,0,0,0,0,35,35,11,46,76.08695652,23.91304348,tract_part,http://www.prisonersofthecensus.org/data/2010blocks/482979502001033/
4.83E+14,445,29,22,2,82,26,308,914,185,1099,83.16651501,16.83348499,tract_part,http://www.prisonersofthecensus.org/data/2010blocks/482979501001238/
4.83E+14,4,0,0,0,0,0,2,6,8,14,42.85714286,57.14285714,tract_part,http://www.prisonersofthecensus.org/data/2010blocks/483030002012018/
4.83E+14,213,0,0,0,0,0,291,504,225,729,69.13580247,30.86419753,tract,http://www.prisonersofthecensus.org/data/2010blocks/483030007001165/
4.83E+14,14,0,0,0,20,0,19,53,27,80,66.25,33.75,tract,http://www.prisonersofthecensus.org/data/2010blocks/483030010003086/
4.83E+14,6,0,0,0,0,0,2,8,2,10,80,20,tract,http://www.prisonersofthecensus.org/data/2010blocks/483030022043016/
4.83E+14,18,4,0,0,12,10,62,106,80,186,56.98924731,43.01075269,tract_part,http://www.prisonersofthecensus.org/data/2010blocks/483030102004099/
4.83E+14,302,3,0,0,39,17,215,576,392,968,59.50413223,40.49586777,tract_part,http://www.prisonersofthecensus.org/data/2010blocks/483030105082076/
4.83E+14,3,1,0,0,4,0,25,33,14,47,70.21276596,29.78723404,tract_part,http://www.prisonersofthecensus.org/data/2010blocks/483059505002018/
4.83E+14,1,0,0,0,5,1,6,13,12,25,52,48,tract_part,http://www.prisonersofthecensus.org/data/2010blocks/483079503001134/
4.83E+14,4,0,0,0,0,0,0,4,0,4,100,0,tract_part,http://www.prisonersofthecensus.org/data/2010blocks/483090017002004/
4.83E+14,13,0,0,0,0,0,5,18,26,44,40.90909091,59.09090909,institutionalized,http://www.prisonersofthecensus.org/data/2010blocks/483090001001033/
4.83E+14,84,1,1,0,23,3,57,169,145,314,53.82165605,46.17834395,institutionalized,http://www.prisonersofthecensus.org/data/2010blocks/483090001002019/
4.83E+14,338,0,0,0,49,7,222,616,293,909,67.76677668,32.23322332,tract_part,http://www.prisonersofthecensus.org/data/2010blocks/483090018002048/
4.83E+14,1002,6,7,1,454,20,744,2234,602,2836,78.77291961,21.22708039,tract_part,http://www.prisonersofthecensus.org/data/2010blocks/483130001002021/
4.83E+14,26,1,0,0,1,0,4,32,35,67,47.76119403,52.23880597,tract_part,http://www.prisonersofthecensus.org/data/2010blocks/483159504001082/
4.83E+14,1,0,0,0,2,0,4,7,2,9,77.77777778,22.22222222,tract_part,http://www.prisonersofthecensus.org/data/2010blocks/483179502002048/
4.83E+14,0,0,0,0,0,0,0,0,3,3,0,100,tract_part,http://www.prisonersofthecensus.org/data/2010blocks/483199501003075/
4.83E+14,42,0,1,0,36,0,36,115,49,164,70.12195122,29.87804878,tract_part,http://www.prisonersofthecensus.org/data/2010blocks/483217304003029/
4.83E+14,0,0,0,0,1,0,1,2,0,2,100,0,tract_part,http://www.prisonersofthecensus.org/data/2010blocks/483217306002064/
4.83E+14,0,5,0,0,2,0,244,251,3,254,98.81889764,1.181102362,tract_part,http://www.prisonersofthecensus.org/data/2010blocks/483239507004066/
4.83E+14,1,0,12,0,37,1,604,655,9,664,98.64457831,1.355421687,tract_part,http://www.prisonersofthecensus.org/data/2010blocks/483239507001320/
4.83E+14,0,0,0,0,0,0,56,56,8,64,87.5,12.5,institutionalized,http://www.prisonersofthecensus.org/data/2010blocks/483250003002060/
4.83E+14,631,1,8,0,0,0,921,1561,273,1834,85.11450382,14.88549618,institutionalized,http://www.prisonersofthecensus.org/data/2010blocks/483250003002102/
4.83E+14,0,0,0,0,0,0,3,3,2,5,60,40,tract_part,http://www.prisonersofthecensus.org/data/2010blocks/483279503003045/
4.83E+14,50,0,1,0,0,0,85,136,68,204,66.66666667,33.33333333,tract,http://www.prisonersofthecensus.org/data/2010blocks/483290014001008/
4.83E+14,25,0,0,0,0,0,34,59,25,84,70.23809524,29.76190476,tract,http://www.prisonersofthecensus.org/data/2010blocks/483290102002095/
4.83E+14,15,0,0,0,0,2,34,51,27,78,65.38461538,34.61538462,tract_part,http://www.prisonersofthecensus.org/data/2010blocks/483290101141010/
4.83E+14,27,0,0,0,5,0,11,43,48,91,47.25274725,52.74725275,tract_part,http://www.prisonersofthecensus.org/data/2010blocks/483319504022115/
4.83E+14,0,0,0,0,0,0,1,1,3,4,25,75,tract_part,http://www.prisonersofthecensus.org/data/2010blocks/483339502002040/
4.83E+14,3,0,0,0,8,1,11,23,6,29,79.31034483,20.68965517,tract_part,http://www.prisonersofthecensus.org/data/2010blocks/483359502002081/
4.83E+14,789,0,8,0,969,0,971,2737,497,3234,84.63203463,15.36796537,tract_part,http://www.prisonersofthecensus.org/data/2010blocks/483359502001001/
4.83E+14,2,0,0,0,0,0,4,6,45,51,11.76470588,88.23529412,tract_part,http://www.prisonersofthecensus.org/data/2010blocks/483379506002052/
4.83E+14,257,8,9,0,160,25,897,1356,650,2006,67.59720837,32.40279163,tract_part,http://www.prisonersofthecensus.org/data/2010blocks/483396939002000/
4.83E+14,4,0,1,1,0,0,5,11,45,56,19.64285714,80.35714286,tract_part,http://www.prisonersofthecensus.org/data/2010blocks/483396941014039/
4.83E+14,1,0,0,0,0,0,1,2,7,9,22.22222222,77.77777778,tract_part,http://www.prisonersofthecensus.org/data/2010blocks/483396941012037/
4.83E+14,4,0,3,0,0,0,21,28,11,39,71.79487179,28.20512821,tract_part,http://www.prisonersofthecensus.org/data/2010blocks/483419504001025/
4.83E+14,12,0,0,0,0,0,2,14,15,29,48.27586207,51.72413793,tract_part,http://www.prisonersofthecensus.org/data/2010blocks/483439503002002/
4.83E+14,122,0,0,0,0,0,10,132,72,204,64.70588235,35.29411765,tract_part,http://www.prisonersofthecensus.org/data/2010blocks/483479507003015/
4.84E+14,68,2,0,1,12,4,25,112,80,192,58.33333333,41.66666667,tract,http://www.prisonersofthecensus.org/data/2010blocks/483499708002008/
4.84E+14,15,0,0,0,0,0,1,16,19,35,45.71428571,54.28571429,institutionalized,http://www.prisonersofthecensus.org/data/2010blocks/483519502002037/
4.84E+14,319,0,3,0,0,0,73,395,231,626,63.09904153,36.90095847,institutionalized,http://www.prisonersofthecensus.org/data/2010blocks/483519502003003/
4.84E+14,4,0,0,0,0,0,0,4,4,8,50,50,institutionalized,http://www.prisonersofthecensus.org/data/2010blocks/483519502003035/
4.84E+14,7,0,0,0,0,0,14,21,28,49,42.85714286,57.14285714,tract_part,http://www.prisonersofthecensus.org/data/2010blocks/483539503002087/
4.84E+14,19,2,0,0,41,12,263,337,87,424,79.48113208,20.51886792,institutionalized,http://www.prisonersofthecensus.org/data/2010blocks/483550008001024/
4.84E+14,30,0,1,0,0,0,171,202,87,289,69.89619377,30.10380623,institutionalized,http://www.prisonersofthecensus.org/data/2010blocks/483550008002062/
4.84E+14,6,1,0,0,2,12,75,96,21,117,82.05128205,17.94871795,tract_part,http://www.prisonersofthecensus.org/data/2010blocks/483550063001326/
4.84E+14,87,0,0,0,0,0,610,697,211,908,76.76211454,23.23788546,institutionalized,http://www.prisonersofthecensus.org/data/2010blocks/483550064002128/
4.84E+14,3,1,0,0,5,0,33,42,12,54,77.77777778,22.22222222,institutionalized,http://www.prisonersofthecensus.org/data/2010blocks/483550064002131/
4.84E+14,0,0,0,0,0,0,12,12,6,18,66.66666667,33.33333333,tract_part,http://www.prisonersofthecensus.org/data/2010blocks/483579503003067/
4.84E+14,0,0,0,0,0,0,0,0,2,2,0,100,tract_part,http://www.prisonersofthecensus.org/data/2010blocks/483599501001080/
4.84E+14,41,0,0,0,1,0,1,43,109,152,28.28947368,71.71052632,tract_part,http://www.prisonersofthecensus.org/data/2010blocks/483610203003051/
4.84E+14,10,0,0,0,0,0,10,20,77,97,20.6185567,79.3814433,tract_part,http://www.prisonersofthecensus.org/data/2010blocks/483630003002078/
4.84E+14,23,0,0,0,5,0,6,34,25,59,57.62711864,42.37288136,tract_part,http://www.prisonersofthecensus.org/data/2010blocks/483659504006038/
4.84E+14,26,0,0,0,0,3,31,60,321,381,15.7480315,84.2519685,tract_part,http://www.prisonersofthecensus.org/data/2010blocks/483671401021092/
4.84E+14,740,1,3,0,624,3,625,1996,602,2598,76.82832948,23.17167052,tract_part,http://www.prisonersofthecensus.org/data/2010blocks/483671405023157/
4.84E+14,3,0,0,0,0,0,15,18,8,26,69.23076923,30.76923077,tract_part,http://www.prisonersofthecensus.org/data/2010blocks/483699503004034/
4.84E+14,126,2,1,1,61,6,222,419,242,661,63.38880484,36.61119516,tract_part,http://www.prisonersofthecensus.org/data/2010blocks/483719505001559/
4.84E+14,336,4,1,0,93,14,498,946,516,1462,64.70588235,35.29411765,tract_part,http://www.prisonersofthecensus.org/data/2010blocks/483719505003417/
4.84E+14,43,1,0,0,0,0,1,45,65,110,40.90909091,59.09090909,tract_part,http://www.prisonersofthecensus.org/data/2010blocks/483732103024015/
4.84E+14,1359,4,18,1,735,13,1017,3147,1403,4550,69.16483516,30.83516484,tract_part,http://www.prisonersofthecensus.org/data/2010blocks/483732102031001/
4.84E+14,55,2,2,0,18,5,80,162,144,306,52.94117647,47.05882353,tract_part,http://www.prisonersofthecensus.org/data/2010blocks/483750144012032/
4.84E+14,26,0,0,0,3,2,29,60,30,90,66.66666667,33.33333333,tract,http://www.prisonersofthecensus.org/data/2010blocks/483750154001107/
4.84E+14,1968,2,13,0,18,4,1628,3633,1679,5312,68.39231928,31.60768072,tract_part,http://www.prisonersofthecensus.org/data/2010blocks/483750144011008/
4.84E+14,0,1,0,0,0,1,0,2,23,25,8,92,tract_part,http://www.prisonersofthecensus.org/data/2010blocks/483799501002022/
4.84E+14,43,2,3,0,26,5,85,164,181,345,47.53623188,52.46376812,tract_part,http://www.prisonersofthecensus.org/data/2010blocks/483810217031004/
4.84E+14,9,0,0,0,0,0,0,9,19,28,32.14285714,67.85714286,tract_part,http://www.prisonersofthecensus.org/data/2010blocks/483879505005013/
4.84E+14,513,0,25,1,262,4,1512,2317,972,3289,70.44694436,29.55305564,tract_part,http://www.prisonersofthecensus.org/data/2010blocks/483899501001460/
4.84E+14,3,0,0,0,2,0,16,21,6,27,77.77777778,22.22222222,tract_part,http://www.prisonersofthecensus.org/data/2010blocks/483919502004028/
4.84E+14,24,0,0,0,5,0,7,36,10,46,78.26086957,21.73913043,tract_part,http://www.prisonersofthecensus.org/data/2010blocks/483959603002075/
4.84E+14,36,0,0,0,0,0,9,45,122,167,26.94610778,73.05389222,tract_part,http://www.prisonersofthecensus.org/data/2010blocks/483970403021047/
4.84E+14,3,0,0,0,0,0,17,20,28,48,41.66666667,58.33333333,tract_part,http://www.prisonersofthecensus.org/data/2010blocks/483999506005409/
4.84E+14,671,4,4,0,121,12,448,1260,923,2183,57.71873568,42.28126432,tract_part,http://www.prisonersofthecensus.org/data/2010blocks/484019507001063/
4.84E+14,860,2,5,0,77,9,273,1226,830,2056,59.63035019,40.36964981,tract_part,http://www.prisonersofthecensus.org/data/2010blocks/484019505022047/
4.84E+14,0,0,0,0,0,0,0,0,118,118,0,100,tract_part,http://www.prisonersofthecensus.org/data/2010blocks/484019512002045/
4.84E+14,8,1,0,0,0,0,1,10,58,68,14.70588235,85.29411765,tract_part,http://www.prisonersofthecensus.org/data/2010blocks/484019504004029/
4.84E+14,162,1,1,0,42,7,172,385,163,548,70.25547445,29.74452555,tract_part,http://www.prisonersofthecensus.org/data/2010blocks/484019504001025/
4.84E+14,10,0,0,0,2,1,5,18,38,56,32.14285714,67.85714286,tract_part,http://www.prisonersofthecensus.org/data/2010blocks/484072002003038/
4.84E+14,0,0,0,0,0,0,0,0,1,1,0,100,tract_part,http://www.prisonersofthecensus.org/data/2010blocks/484090102021025/
4.84E+14,1,0,0,0,0,0,36,37,21,58,63.79310345,36.20689655,institutionalized,http://www.prisonersofthecensus.org/data/2010blocks/484090110002012/
4.84E+14,6,0,0,0,0,0,1,7,183,190,3.684210526,96.31578947,institutionalized,http://www.prisonersofthecensus.org/data/2010blocks/484090110003017/
4.84E+14,1,0,0,0,0,0,1,2,6,8,25,75,tract_part,http://www.prisonersofthecensus.org/data/2010blocks/484119501003052/
4.84E+14,168,0,3,0,0,0,199,370,205,575,64.34782609,35.65217391,tract_part,http://www.prisonersofthecensus.org/data/2010blocks/484119502002090/
4.84E+14,4,0,0,0,0,0,15,19,21,40,47.5,52.5,tract_part,http://www.prisonersofthecensus.org/data/2010blocks/484159506003016/
4.84E+14,318,2,5,0,451,0,447,1223,516,1739,70.32777458,29.67222542,tract_part,http://www.prisonersofthecensus.org/data/2010blocks/484159501001435/
4.84E+14,0,0,0,0,0,0,2,2,1,3,66.66666667,33.33333333,tract_part,http://www.prisonersofthecensus.org/data/2010blocks/484219502002039/
4.84E+14,17,1,0,0,1,1,2,22,24,46,47.82608696,52.17391304,institutionalized,http://www.prisonersofthecensus.org/data/2010blocks/484230005002060/
4.84E+14,116,0,0,0,4,0,22,142,122,264,53.78787879,46.21212121,institutionalized,http://www.prisonersofthecensus.org/data/2010blocks/484230005002084/
4.84E+14,160,6,0,0,1,12,63,242,181,423,57.21040189,42.78959811,tract_part,http://www.prisonersofthecensus.org/data/2010blocks/484230016012062/
4.84E+14,24,1,0,0,0,0,5,30,33,63,47.61904762,52.38095238,tract_part,http://www.prisonersofthecensus.org/data/2010blocks/484230016042046/
4.84E+14,2,0,0,0,6,0,6,14,6,20,70,30,tract_part,http://www.prisonersofthecensus.org/data/2010blocks/484230017001111/
4.84E+14,2,0,0,0,8,1,601,612,5,617,99.18962723,0.810372771,tract,http://www.prisonersofthecensus.org/data/2010blocks/484279505004016/
4.84E+14,1,0,0,0,0,0,2,3,14,17,17.64705882,82.35294118,tract_part,http://www.prisonersofthecensus.org/data/2010blocks/484299502001048/
4.84E+14,68,1,0,0,175,0,176,420,241,661,63.54009077,36.45990923,tract_part,http://www.prisonersofthecensus.org/data/2010blocks/484299505003291/
4.84E+14,1,0,1,0,1,0,5,8,4,12,66.66666667,33.33333333,tract_part,http://www.prisonersofthecensus.org/data/2010blocks/484359503002451/
4.84E+14,211,0,1,0,0,0,220,432,146,578,74.74048443,25.25951557,tract_part,http://www.prisonersofthecensus.org/data/2010blocks/484379502002526/
4.84E+14,5,0,0,0,0,0,9,14,2,16,87.5,12.5,tract_part,http://www.prisonersofthecensus.org/data/2010blocks/484379503003073/
4.84E+14,0,0,0,0,0,0,0,0,1,1,0,100,tract_part,http://www.prisonersofthecensus.org/data/2010blocks/484391114051019/
4.84E+14,62,5,4,1,26,1,61,160,64,224,71.42857143,28.57142857,tract,http://www.prisonersofthecensus.org/data/2010blocks/484391113092000/
4.84E+14,4,0,0,0,0,0,2,6,1,7,85.71428571,14.28571429,tract_part,http://www.prisonersofthecensus.org/data/2010blocks/484391115061000/
4.84E+14,0,0,0,0,0,0,4,4,123,127,3.149606299,96.8503937,tract_part,http://www.prisonersofthecensus.org/data/2010blocks/484391142043019/
4.84E+14,0,0,0,0,0,0,2,2,0,2,100,0,tract,http://www.prisonersofthecensus.org/data/2010blocks/484391109053036/
4.84E+14,393,76,12,1,147,54,506,1189,611,1800,66.05555556,33.94444444,tract_part,http://www.prisonersofthecensus.org/data/2010blocks/484391006022054/
4.84E+14,27,1,2,0,4,0,24,58,32,90,64.44444444,35.55555556,tract,http://www.prisonersofthecensus.org/data/2010blocks/484391037013004/
4.84E+14,192,0,1,0,47,3,124,367,106,473,77.58985201,22.41014799,tract_part,http://www.prisonersofthecensus.org/data/2010blocks/484391050012001/
4.84E+14,451,45,23,6,129,50,555,1259,552,1811,69.51960243,30.48039757,tract_part,http://www.prisonersofthecensus.org/data/2010blocks/484391059021016/
4.84E+14,102,2,0,1,7,0,25,137,93,230,59.56521739,40.43478261,tract,http://www.prisonersofthecensus.org/data/2010blocks/484391232001247/
4.84E+14,571,0,0,0,0,4,131,706,797,1503,46.97272122,53.02727878,tract,http://www.prisonersofthecensus.org/data/2010blocks/484391233002056/
4.84E+14,0,0,1,0,0,0,2,3,2,5,60,40,institutionalized,http://www.prisonersofthecensus.org/data/2010blocks/484391136281018/
4.84E+14,3,0,0,0,0,0,5,8,25,33,24.24242424,75.75757576,institutionalized,http://www.prisonersofthecensus.org/data/2010blocks/484391136282010/
4.84E+14,7,0,1,0,0,0,1,9,6,15,60,40,tract_part,http://www.prisonersofthecensus.org/data/2010blocks/484391136133020/
4.84E+14,185,5,3,0,96,10,353,652,310,962,67.77546778,32.22453222,tract_part,http://www.prisonersofthecensus.org/data/2010blocks/484459503003051/
4.84E+14,5,0,0,0,12,1,33,51,11,62,82.25806452,17.74193548,institutionalized,http://www.prisonersofthecensus.org/data/2010blocks/484459504001008/
4.84E+14,20,2,0,0,23,1,60,106,40,146,72.60273973,27.39726027,institutionalized,http://www.prisonersofthecensus.org/data/2010blocks/484459504003016/
4.85E+14,44,0,1,0,0,0,199,244,167,411,59.36739659,40.63260341,tract,http://www.prisonersofthecensus.org/data/2010blocks/484510018001039/
4.85E+14,9,0,0,0,0,0,3,12,19,31,38.70967742,61.29032258,tract_part,http://www.prisonersofthecensus.org/data/2010blocks/484510017043227/
4.85E+14,0,0,0,0,1,0,1,2,0,2,100,0,tract,http://www.prisonersofthecensus.org/data/2010blocks/484530006042009/
4.85E+14,21,2,0,1,3,0,29,56,49,105,53.33333333,46.66666667,tract,http://www.prisonersofthecensus.org/data/2010blocks/484530008032002/
4.85E+14,68,0,1,0,0,0,82,151,130,281,53.7366548,46.2633452,tract,http://www.prisonersofthecensus.org/data/2010blocks/484530011001022/
4.85E+14,0,0,0,0,0,0,0,0,4,4,0,100,tract,http://www.prisonersofthecensus.org/data/2010blocks/484530012002010/
4.85E+14,7,0,0,0,2,1,4,14,15,29,48.27586207,51.72413793,tract,http://www.prisonersofthecensus.org/data/2010blocks/484530021051004/
4.85E+14,5,0,0,0,0,0,0,5,4,9,55.55555556,44.44444444,tract,http://www.prisonersofthecensus.org/data/2010blocks/484530021123000/
4.85E+14,0,0,0,0,4,0,4,8,0,8,100,0,tract,http://www.prisonersofthecensus.org/data/2010blocks/484530021133012/
4.85E+14,493,1,5,0,346,3,354,1202,253,1455,82.61168385,17.38831615,tract_part,http://www.prisonersofthecensus.org/data/2010blocks/484530022083000/
4.85E+14,49,0,0,0,19,4,38,110,92,202,54.45544554,45.54455446,tract_part,http://www.prisonersofthecensus.org/data/2010blocks/484530023191001/
4.85E+14,563,2,4,0,5,19,483,1076,714,1790,60.11173184,39.88826816,tract_part,http://www.prisonersofthecensus.org/data/2010blocks/484530023191004/
4.85E+14,0,0,0,0,0,0,0,0,2,2,0,100,institutionalized,http://www.prisonersofthecensus.org/data/2010blocks/484559502001030/
4.85E+14,1,0,0,0,0,0,0,1,1,2,50,50,institutionalized,http://www.prisonersofthecensus.org/data/2010blocks/484559502001043/
4.85E+14,18,0,0,0,0,0,0,18,54,72,25,75,tract_part,http://www.prisonersofthecensus.org/data/2010blocks/484579503001051/
4.85E+14,803,0,2,0,398,6,403,1612,523,2135,75.50351288,24.49648712,tract_part,http://www.prisonersofthecensus.org/data/2010blocks/484579502001070/
4.85E+14,1,0,0,0,0,0,0,1,0,1,100,0,tract_part,http://www.prisonersofthecensus.org/data/2010blocks/484599504003017/
4.85E+14,3,0,0,0,8,1,18,30,11,41,73.17073171,26.82926829,tract_part,http://www.prisonersofthecensus.org/data/2010blocks/484619501001766/
4.85E+14,6,3,0,0,12,1,47,69,28,97,71.13402062,28.86597938,tract_part,http://www.prisonersofthecensus.org/data/2010blocks/484639503001065/
4.85E+14,1,0,0,0,0,0,21,22,6,28,78.57142857,21.42857143,tract_part,http://www.prisonersofthecensus.org/data/2010blocks/484639504002054/
4.85E+14,18,5,0,0,123,72,1098,1316,37,1353,97.26533629,2.73466371,tract_part,http://www.prisonersofthecensus.org/data/2010blocks/484659505003108/
4.85E+14,16,1,0,0,2,1,14,34,103,137,24.81751825,75.18248175,tract_part,http://www.prisonersofthecensus.org/data/2010blocks/484679507001049/
4.85E+14,60,0,0,0,1,0,247,308,102,410,75.12195122,24.87804878,tract,http://www.prisonersofthecensus.org/data/2010blocks/484690001001039/
4.85E+14,864,10,3,0,144,16,458,1495,777,2272,65.80105634,34.19894366,institutionalized,http://www.prisonersofthecensus.org/data/2010blocks/484717904002005/
4.85E+14,987,4,5,0,161,18,471,1646,1132,2778,59.2512599,40.7487401,institutionalized,http://www.prisonersofthecensus.org/data/2010blocks/484717904003020/
4.85E+14,355,3,3,1,64,5,199,630,396,1026,61.40350877,38.59649123,institutionalized,http://www.prisonersofthecensus.org/data/2010blocks/484717905001005/
4.85E+14,57,0,0,0,3,0,15,75,40,115,65.2173913,34.7826087,institutionalized,http://www.prisonersofthecensus.org/data/2010blocks/484717905002009/
4.85E+14,509,5,5,0,108,7,313,947,739,1686,56.16844603,43.83155397,tract,http://www.prisonersofthecensus.org/data/2010blocks/484717906003002/
4.85E+14,31,2,0,1,58,3,165,260,438,698,37.24928367,62.75071633,institutionalized,http://www.prisonersofthecensus.org/data/2010blocks/484717902001034/
4.85E+14,319,0,0,0,0,0,0,319,1,320,99.6875,0.3125,institutionalized,http://www.prisonersofthecensus.org/data/2010blocks/484717902001036/
4.85E+14,918,4,1,0,145,7,379,1454,947,2401,60.55810079,39.44189921,institutionalized,http://www.prisonersofthecensus.org/data/2010blocks/484717901011107/
4.85E+14,1191,9,3,0,220,26,613,2062,1209,3271,63.03882605,36.96117395,institutionalized,http://www.prisonersofthecensus.org/data/2010blocks/484717901012000/
4.85E+14,0,0,0,0,0,0,1,1,0,1,100,0,tract_part,http://www.prisonersofthecensus.org/data/2010blocks/484736802003028/
4.85E+14,12,1,0,0,0,1,1,15,90,105,14.28571429,85.71428571,tract_part,http://www.prisonersofthecensus.org/data/2010blocks/484736802003091/
4.85E+14,32,0,1,0,4,0,15,52,25,77,67.53246753,32.46753247,tract_part,http://www.prisonersofthecensus.org/data/2010blocks/484736805002018/
4.85E+14,7,0,0,0,0,0,33,40,14,54,74.07407407,25.92592593,tract_part,http://www.prisonersofthecensus.org/data/2010blocks/484759502001053/
4.85E+14,42,0,0,0,0,1,18,61,20,81,75.30864198,24.69135802,tract_part,http://www.prisonersofthecensus.org/data/2010blocks/484771701003071/
4.85E+14,24,0,1,0,0,0,5,30,35,65,46.15384615,53.84615385,institutionalized,http://www.prisonersofthecensus.org/data/2010blocks/484771703003092/
4.85E+14,10,0,3,0,0,1,8,22,55,77,28.57142857,71.42857143,institutionalized,http://www.prisonersofthecensus.org/data/2010blocks/484771703003094/
4.85E+14,8,0,1,0,4,1,5,19,45,64,29.6875,70.3125,institutionalized,http://www.prisonersofthecensus.org/data/2010blocks/484771703003098/
4.85E+14,4,0,0,0,0,0,2,6,50,56,10.71428571,89.28571429,institutionalized,http://www.prisonersofthecensus.org/data/2010blocks/484771703003144/
4.85E+14,7,0,1,0,77,5,200,290,3,293,98.97610922,1.023890785,tract_part,http://www.prisonersofthecensus.org/data/2010blocks/484790017142033/
4.85E+14,69,6,1,0,239,37,1000,1352,303,1655,81.6918429,18.3081571,tract_part,http://www.prisonersofthecensus.org/data/2010blocks/484790018172004/
4.85E+14,39,0,0,0,6,1,35,81,13,94,86.17021277,13.82978723,tract_part,http://www.prisonersofthecensus.org/data/2010blocks/484817404001070/
4.85E+14,1,0,0,0,0,0,0,1,2,3,33.33333333,66.66666667,tract_part,http://www.prisonersofthecensus.org/data/2010blocks/484839501001025/
4.85E+14,59,3,0,0,35,0,35,132,138,270,48.88888889,51.11111111,tract,http://www.prisonersofthecensus.org/data/2010blocks/484850101001012/
4.85E+14,87,1,0,0,0,0,69,157,162,319,49.21630094,50.78369906,tract_part,http://www.prisonersofthecensus.org/data/2010blocks/484850115003005/
4.85E+14,1388,1,4,0,1163,1,1175,3732,1056,4788,77.94486216,22.05513784,tract_part,http://www.prisonersofthecensus.org/data/2010blocks/484850131004001/
4.85E+14,9,0,0,0,0,0,12,21,17,38,55.26315789,44.73684211,tract_part,http://www.prisonersofthecensus.org/data/2010blocks/484879506001021/
4.85E+14,0,0,0,0,0,1,108,109,1,110,99.09090909,0.909090909,institutionalized,http://www.prisonersofthecensus.org/data/2010blocks/484899504001131/
4.85E+14,336,0,104,0,1,3,2479,2923,175,3098,94.35119432,5.648805681,institutionalized,http://www.prisonersofthecensus.org/data/2010blocks/484899504001182/
4.85E+14,9,0,1,0,1,0,11,22,79,101,21.78217822,78.21782178,tract_part,http://www.prisonersofthecensus.org/data/2010blocks/484910213002022/
4.85E+14,68,0,22,0,50,26,705,871,246,1117,77.97672337,22.02327663,tract_part,http://www.prisonersofthecensus.org/data/2010blocks/484910213001025/
4.85E+14,342,0,1,0,259,4,296,902,406,1308,68.96024465,31.03975535,tract,http://www.prisonersofthecensus.org/data/2010blocks/484910214022015/
4.85E+14,16,0,9,0,76,8,343,452,120,572,79.02097902,20.97902098,tract_part,http://www.prisonersofthecensus.org/data/2010blocks/484910210003004/
4.85E+14,5,0,0,0,0,0,41,46,13,59,77.96610169,22.03389831,tract_part,http://www.prisonersofthecensus.org/data/2010blocks/484930003003031/
4.85E+14,1,0,0,0,0,0,83,84,13,97,86.59793814,13.40206186,tract_part,http://www.prisonersofthecensus.org/data/2010blocks/484959504001526/
4.85E+14,198,1,1,0,131,1,198,530,149,679,78.05596465,21.94403535,tract_part,http://www.prisonersofthecensus.org/data/2010blocks/484971504014061/
4.85E+14,52,0,1,0,14,2,35,104,112,216,48.14814815,51.85185185,tract_part,http://www.prisonersofthecensus.org/data/2010blocks/484971505001001/
4.85E+14,10,1,0,0,0,0,2,13,44,57,22.80701754,77.19298246,tract_part,http://www.prisonersofthecensus.org/data/2010blocks/484999505002023/
4.85E+14,39,0,0,0,2,1,12,54,131,185,29.18918919,70.81081081,tract_part,http://www.prisonersofthecensus.org/data/2010blocks/484999502002053/
4.85E+14,8,0,0,0,0,0,8,16,69,85,18.82352941,81.17647059,tract_part,http://www.prisonersofthecensus.org/data/2010blocks/485039504001069/
4.85E+14,0,0,0,0,4,0,60,64,1,65,98.46153846,1.538461538,tract_part,http://www.prisonersofthecensus.org/data/2010blocks/485079503024038/
4.85E+14,0,0,0,0,0,0,327,327,21,348,93.96551724,6.034482759,tract_part,http://www.prisonersofthecensus.org/data/2010blocks/485079503011455/
4.90E+14,0,0,0,0,1,0,3,4,11,15,26.66666667,73.33333333,tract_part,http://www.prisonersofthecensus.org/data/2010blocks/490011001001399/
4.90E+14,2,5,0,0,0,0,19,26,93,119,21.8487395,78.1512605,tract_part,http://www.prisonersofthecensus.org/data/2010blocks/490039605002078/
4.90E+14,9,12,2,1,14,2,63,103,208,311,33.11897106,66.88102894,tract_part,http://www.prisonersofthecensus.org/data/2010blocks/490050003003070/
4.90E+14,0,0,1,0,0,1,3,5,14,19,26.31578947,73.68421053,tract,http://www.prisonersofthecensus.org/data/2010blocks/490050006005007/
4.90E+14,4,2,0,0,0,0,15,21,72,93,22.58064516,77.41935484,tract_part,http://www.prisonersofthecensus.org/data/2010blocks/490070002001036/
4.90E+14,4,2,2,0,6,1,8,23,46,69,33.33333333,66.66666667,tract_part,http://www.prisonersofthecensus.org/data/2010blocks/490099601001083/
4.90E+14,35,22,0,21,33,1,159,271,343,614,44.13680782,55.86319218,institutionalized,http://www.prisonersofthecensus.org/data/2010blocks/490111262021104/
4.90E+14,3,0,0,2,5,0,12,22,80,102,21.56862745,78.43137255,remaining,http://www.prisonersofthecensus.org/data/2010blocks/490111262021105/
4.90E+14,6,13,3,3,4,2,16,47,117,164,28.65853659,71.34146341,tract_part,http://www.prisonersofthecensus.org/data/2010blocks/490139403003048/
4.90E+14,4,3,0,0,4,7,7,25,69,94,26.59574468,73.40425532,tract_part,http://www.prisonersofthecensus.org/data/2010blocks/490170003002195/
4.90E+14,0,0,0,0,0,0,0,0,8,8,0,100,tract_part,http://www.prisonersofthecensus.org/data/2010blocks/490170003002300/
4.90E+14,0,2,0,0,2,2,2,8,15,23,34.7826087,65.2173913,institutionalized,http://www.prisonersofthecensus.org/data/2010blocks/490190002001064/
4.90E+14,0,1,0,0,0,1,1,3,8,11,27.27272727,72.72727273,institutionalized,http://www.prisonersofthecensus.org/data/2010blocks/490190002004023/
4.90E+14,4,9,1,0,4,0,13,31,112,143,21.67832168,78.32167832,tract_part,http://www.prisonersofthecensus.org/data/2010blocks/490211105001017/
4.90E+14,3,0,0,0,5,3,9,20,22,42,47.61904762,52.38095238,tract_part,http://www.prisonersofthecensus.org/data/2010blocks/490230102003043/
4.90E+14,1,2,0,0,0,0,3,6,16,22,27.27272727,72.72727273,tract_part,http://www.prisonersofthecensus.org/data/2010blocks/490251302002025/
4.90E+14,0,3,0,0,2,0,2,7,13,20,35,65,tract_part,http://www.prisonersofthecensus.org/data/2010blocks/490279743003220/
4.90E+14,0,0,0,0,0,0,0,0,1,1,0,100,tract_part,http://www.prisonersofthecensus.org/data/2010blocks/490339501002104/
4.90E+14,113,57,6,13,139,18,297,643,836,1479,43.47532116,56.52467884,remaining,http://www.prisonersofthecensus.org/data/2010blocks/490351128181004/
4.90E+14,197,107,6,5,200,97,506,1118,1665,2783,40.17247575,59.82752425,institutionalized,http://www.prisonersofthecensus.org/data/2010blocks/490351128181005/
4.90E+14,2,3,0,0,0,1,8,14,35,49,28.57142857,71.42857143,tract,http://www.prisonersofthecensus.org/data/2010blocks/490351003062004/
4.90E+14,5,6,3,3,0,0,12,29,75,104,27.88461538,72.11538462,tract_part,http://www.prisonersofthecensus.org/data/2010blocks/490351028023012/
4.90E+14,5,5,1,4,0,0,8,23,46,69,33.33333333,66.66666667,tract_part,http://www.prisonersofthecensus.org/data/2010blocks/490351145003094/
4.90E+14,13,5,0,4,2,3,59,86,85,171,50.29239766,49.70760234,tract,http://www.prisonersofthecensus.org/data/2010blocks/490351115001110/
4.90E+14,171,58,27,43,21,14,537,871,1236,2107,41.33839582,58.66160418,tract_part,http://www.prisonersofthecensus.org/data/2010blocks/490351116003000/
4.90E+14,0,0,0,0,0,0,1,1,1,2,50,50,tract,http://www.prisonersofthecensus.org/data/2010blocks/490351129171002/
4.90E+14,1,1,0,0,0,0,1,3,52,55,5.454545455,94.54545455,tract,http://www.prisonersofthecensus.org/data/2010blocks/490351133074004/
4.90E+14,3,2,0,0,1,4,8,18,67,85,21.17647059,78.82352941,tract_part,http://www.prisonersofthecensus.org/data/2010blocks/490379781003033/
4.90E+14,11,3,1,0,17,2,20,54,52,106,50.94339623,49.05660377,tract_part,http://www.prisonersofthecensus.org/data/2010blocks/490399725003132/
4.90E+14,93,87,1,4,253,41,335,814,978,1792,45.42410714,54.57589286,tract_part,http://www.prisonersofthecensus.org/data/2010blocks/490399723001258/
4.90E+14,4,7,0,2,9,4,17,43,68,111,38.73873874,61.26126126,tract_part,http://www.prisonersofthecensus.org/data/2010blocks/490419754001037/
4.90E+14,1,3,0,0,2,5,3,14,58,72,19.44444444,80.55555556,tract_part,http://www.prisonersofthecensus.org/data/2010blocks/490439641022224/
4.90E+14,2,0,1,5,10,7,21,46,99,145,31.72413793,68.27586207,tract,http://www.prisonersofthecensus.org/data/2010blocks/490451312002008/
4.90E+14,1,10,0,0,10,3,11,35,73,108,32.40740741,67.59259259,tract_part,http://www.prisonersofthecensus.org/data/2010blocks/490479684012012/
4.90E+14,1,0,1,0,0,0,0,2,10,12,16.66666667,83.33333333,tract_part,http://www.prisonersofthecensus.org/data/2010blocks/490490022073002/
4.90E+14,14,16,8,15,100,34,200,387,469,856,45.21028037,54.78971963,tract_part,http://www.prisonersofthecensus.org/data/2010blocks/490490105032029/
4.91E+14,0,2,0,2,14,1,21,40,49,89,44.94382022,55.05617978,tract_part,http://www.prisonersofthecensus.org/data/2010blocks/490519602001059/
4.91E+14,1,1,5,0,13,3,77,100,66,166,60.24096386,39.75903614,tract_part,http://www.prisonersofthecensus.org/data/2010blocks/490519405004038/
4.91E+14,16,20,7,1,62,5,90,201,287,488,41.18852459,58.81147541,tract_part,http://www.prisonersofthecensus.org/data/2010blocks/490532709022056/
4.91E+14,0,0,0,0,0,0,0,0,24,24,0,100,tract_part,http://www.prisonersofthecensus.org/data/2010blocks/490532703001024/
4.91E+14,38,10,4,0,2,2,358,414,382,796,52.01005025,47.98994975,tract_part,http://www.prisonersofthecensus.org/data/2010blocks/490572104022061/
4.91E+14,0,0,0,0,0,0,2,2,0,2,100,0,tract,http://www.prisonersofthecensus.org/data/2010blocks/490572005005005/
4.91E+14,10,5,0,0,0,0,30,45,86,131,34.35114504,65.64885496,tract_part,http://www.prisonersofthecensus.org/data/2010blocks/490572011001060/
4.91E+14,17,6,1,0,3,2,25,54,108,162,33.33333333,66.66666667,tract_part,http://www.prisonersofthecensus.org/data/2010blocks/490572019001026/
5.00E+14,7,0,1,0,0,0,7,15,4,19,78.94736842,21.05263158,tract_part,http://www.prisonersofthecensus.org/data/2010blocks/500019607003013/
5.00E+14,15,8,1,0,1,4,8,37,191,228,16.22807018,83.77192982,tract_part,http://www.prisonersofthecensus.org/data/2010blocks/500059574001114/
5.00E+14,25,4,0,0,0,3,3,35,133,168,20.83333333,79.16666667,tract,http://www.prisonersofthecensus.org/data/2010blocks/500070033041011/
5.00E+14,14,2,1,0,0,7,9,33,125,158,20.88607595,79.11392405,tract,http://www.prisonersofthecensus.org/data/2010blocks/500110106004010/
5.00E+14,33,8,0,0,3,22,26,92,330,422,21.80094787,78.19905213,tract,http://www.prisonersofthecensus.org/data/2010blocks/500199514002036/
5.00E+14,7,2,0,0,5,4,9,27,123,150,18,82,tract,http://www.prisonersofthecensus.org/data/2010blocks/500219632003005/
5.00E+14,0,0,0,0,0,0,0,0,7,7,0,100,tract,http://www.prisonersofthecensus.org/data/2010blocks/500239552004009/
5.00E+14,26,5,2,0,3,17,14,67,307,374,17.9144385,82.0855615,tract_part,http://www.prisonersofthecensus.org/data/2010blocks/500279667004032/
5.00E+14,12,0,0,0,1,1,6,20,81,101,19.8019802,80.1980198,tract_part,http://www.prisonersofthecensus.org/data/2010blocks/500279660004016/
5.10E+14,66,0,0,0,0,0,6,72,21,93,77.41935484,22.58064516,tract_part,http://www.prisonersofthecensus.org/data/2010blocks/510010904004094/
5.10E+14,294,0,0,0,0,0,18,312,250,562,55.51601423,44.48398577,tract,http://www.prisonersofthecensus.org/data/2010blocks/510030113031007/
5.10E+14,30,0,0,0,0,0,0,30,34,64,46.875,53.125,tract_part,http://www.prisonersofthecensus.org/data/2010blocks/510090102003005/
5.10E+14,57,0,2,0,0,0,2,61,364,425,14.35294118,85.64705882,tract_part,http://www.prisonersofthecensus.org/data/2010blocks/510090105021010/
5.10E+14,311,0,1,0,1,1,77,391,161,552,70.83333333,29.16666667,tract,http://www.prisonersofthecensus.org/data/2010blocks/510131017013001/
5.10E+14,241,0,2,0,1,1,44,289,441,730,39.5890411,60.4109589,tract_part,http://www.prisonersofthecensus.org/data/2010blocks/510150707003036/
5.10E+14,667,1,11,0,31,0,32,742,441,1183,62.72189349,37.27810651,tract_part,http://www.prisonersofthecensus.org/data/2010blocks/510150701004000/
5.10E+14,128,0,1,0,0,1,4,134,123,257,52.14007782,47.85992218,tract_part,http://www.prisonersofthecensus.org/data/2010blocks/510150710003048/
5.10E+14,42,0,0,0,0,0,0,42,33,75,56,44,tract,http://www.prisonersofthecensus.org/data/2010blocks/510190305042046/
5.10E+14,153,0,0,0,1,0,11,165,473,638,25.86206897,74.13793103,tract_part,http://www.prisonersofthecensus.org/data/2010blocks/510210401003012/
5.10E+14,18,0,1,0,1,0,4,24,75,99,24.24242424,75.75757576,tract_part,http://www.prisonersofthecensus.org/data/2010blocks/510230403011068/
5.10E+14,48,0,1,0,0,0,0,49,83,132,37.12121212,62.87878788,institutionalized,http://www.prisonersofthecensus.org/data/2010blocks/510259302021000/
5.10E+14,1212,0,6,3,4,0,18,1243,344,1587,78.32388154,21.67611846,institutionalized,http://www.prisonersofthecensus.org/data/2010blocks/510259302021008/
5.10E+14,42,0,0,0,0,0,0,42,5,47,89.36170213,10.63829787,tract_part,http://www.prisonersofthecensus.org/data/2010blocks/510259302031149/
5.10E+14,475,0,3,2,1,1,4,486,353,839,57.9261025,42.0738975,tract_part,http://www.prisonersofthecensus.org/data/2010blocks/510270106002028/
5.10E+14,678,0,6,1,5,1,27,718,364,1082,66.35859519,33.64140481,tract_part,http://www.prisonersofthecensus.org/data/2010blocks/510299302011059/
5.10E+14,581,1,0,0,9,3,31,625,486,1111,56.25562556,43.74437444,tract_part,http://www.prisonersofthecensus.org/data/2010blocks/510299302011043/
5.10E+14,60,0,0,0,0,0,0,60,80,140,42.85714286,57.14285714,tract_part,http://www.prisonersofthecensus.org/data/2010blocks/510310201011075/
5.10E+14,74,0,0,0,0,0,0,74,59,133,55.63909774,44.36090226,tract_part,http://www.prisonersofthecensus.org/data/2010blocks/510310201022043/
5.10E+14,154,0,1,0,0,0,4,159,91,250,63.6,36.4,tract_part,http://www.prisonersofthecensus.org/data/2010blocks/510330301002343/
5.10E+14,92,0,1,1,1,0,3,98,33,131,74.80916031,25.19083969,tract_part,http://www.prisonersofthecensus.org/data/2010blocks/510330306001043/
5.10E+14,47,0,0,0,1,1,2,51,34,85,60,40,tract_part,http://www.prisonersofthecensus.org/data/2010blocks/510379302001001/
5.10E+14,0,0,0,0,0,0,0,0,3,3,0,100,tract_part,http://www.prisonersofthecensus.org/data/2010blocks/510411009272000/
5.10E+14,5,0,0,0,0,0,0,5,0,5,100,0,tract_part,http://www.prisonersofthecensus.org/data/2010blocks/510411002092004/
5.10E+14,181,0,0,0,0,0,0,181,185,366,49.45355191,50.54644809,tract,http://www.prisonersofthecensus.org/data/2010blocks/510411008172039/
5.10E+14,178,0,0,0,0,1,2,181,179,360,50.27777778,49.72222222,tract_part,http://www.prisonersofthecensus.org/data/2010blocks/510411008212010/
5.10E+14,40,0,0,0,0,0,1,41,34,75,54.66666667,45.33333333,tract_part,http://www.prisonersofthecensus.org/data/2010blocks/510430102003084/
5.10E+14,562,0,12,2,11,3,129,719,493,1212,59.32343234,40.67656766,tract_part,http://www.prisonersofthecensus.org/data/2010blocks/510479305012036/
5.10E+14,36,0,0,0,0,0,3,39,28,67,58.20895522,41.79104478,tract_part,http://www.prisonersofthecensus.org/data/2010blocks/510479302012006/
5.11E+14,2,0,1,0,0,0,0,3,253,256,1.171875,98.828125,tract_part,http://www.prisonersofthecensus.org/data/2010blocks/510510401002051/
5.11E+14,33,0,0,0,0,0,0,33,22,55,60,40,tract_part,http://www.prisonersofthecensus.org/data/2010blocks/510538406002095/
5.11E+14,460,18,37,2,0,2,312,831,391,1222,68.00327332,31.99672668,tract_part,http://www.prisonersofthecensus.org/data/2010blocks/510594405023002/
5.11E+14,32,0,0,1,2,7,5,47,52,99,47.47474747,52.52525253,tract_part,http://www.prisonersofthecensus.org/data/2010blocks/510619303021029/
5.11E+14,596,0,3,0,3,2,8,612,607,1219,50.20508614,49.79491386,tract_part,http://www.prisonersofthecensus.org/data/2010blocks/510650201012059/
5.11E+14,16,0,0,0,0,0,0,16,38,54,29.62962963,70.37037037,tract_part,http://www.prisonersofthecensus.org/data/2010blocks/510670208004017/
5.11E+14,141,0,0,0,3,1,21,166,355,521,31.86180422,68.13819578,tract,http://www.prisonersofthecensus.org/data/2010blocks/510690511022024/
5.11E+14,16,0,0,0,0,1,1,18,57,75,24,76,tract_part,http://www.prisonersofthecensus.org/data/2010blocks/510731002031007/
5.11E+14,230,0,1,0,0,0,1,232,358,590,39.3220339,60.6779661,institutionalized,http://www.prisonersofthecensus.org/data/2010blocks/510754003001003/
5.11E+14,502,0,1,0,0,0,8,511,120,631,80.98256735,19.01743265,institutionalized,http://www.prisonersofthecensus.org/data/2010blocks/510754003001027/
5.11E+14,57,0,0,0,0,0,0,57,0,57,100,0,institutionalized,http://www.prisonersofthecensus.org/data/2010blocks/510754003001029/
5.11E+14,82,0,0,0,0,1,9,92,131,223,41.25560538,58.74439462,tract_part,http://www.prisonersofthecensus.org/data/2010blocks/510818801011355/
5.11E+14,2272,2,6,1,1,9,46,2337,948,3285,71.14155251,28.85844749,tract,http://www.prisonersofthecensus.org/data/2010blocks/510818801021002/
5.11E+14,124,0,0,0,0,0,0,124,41,165,75.15151515,24.84848485,tract_part,http://www.prisonersofthecensus.org/data/2010blocks/510839306002017/
5.11E+14,104,0,0,0,0,0,0,104,57,161,64.59627329,35.40372671,tract_part,http://www.prisonersofthecensus.org/data/2010blocks/510839306004034/
5.11E+14,211,1,2,0,7,7,58,286,176,462,61.9047619,38.0952381,tract_part,http://www.prisonersofthecensus.org/data/2010blocks/510853207022021/
5.11E+14,447,0,5,1,1,0,22,476,204,680,70,30,tract,http://www.prisonersofthecensus.org/data/2010blocks/510872004091039/
5.11E+14,13,0,0,0,0,0,0,13,6,19,68.42105263,31.57894737,tract,http://www.prisonersofthecensus.org/data/2010blocks/510872008041005/
5.11E+14,58,0,0,0,0,0,2,60,56,116,51.72413793,48.27586207,tract_part,http://www.prisonersofthecensus.org/data/2010blocks/510890107001035/
5.11E+14,91,0,0,0,3,0,6,100,91,191,52.35602094,47.64397906,tract_part,http://www.prisonersofthecensus.org/data/2010blocks/510890102001000/
5.11E+14,207,7,2,0,2,13,16,247,193,440,56.13636364,43.86363636,tract,http://www.prisonersofthecensus.org/data/2010blocks/510950801021068/
5.11E+14,14,0,0,0,0,0,0,14,11,25,56,44,tract_part,http://www.prisonersofthecensus.org/data/2010blocks/511030301002039/
5.11E+14,835,51,17,6,87,63,257,1316,319,1635,80.48929664,19.51070336,tract_part,http://www.prisonersofthecensus.org/data/2010blocks/511059503003047/
5.11E+14,54,1,5,1,11,9,36,117,70,187,62.56684492,37.43315508,tract_part,http://www.prisonersofthecensus.org/data/2010blocks/511076106043018/
5.11E+14,715,0,2,0,5,2,30,754,426,1180,63.89830508,36.10169492,tract_part,http://www.prisonersofthecensus.org/data/2010blocks/511119301003071/
5.11E+14,0,0,0,0,0,0,0,0,3,3,0,100,tract_part,http://www.prisonersofthecensus.org/data/2010blocks/511139302004073/
5.11E+14,84,0,0,0,1,0,3,88,42,130,67.69230769,32.30769231,tract_part,http://www.prisonersofthecensus.org/data/2010blocks/511179306002086/
5.11E+14,359,0,0,0,0,0,2,361,103,464,77.80172414,22.19827586,tract_part,http://www.prisonersofthecensus.org/data/2010blocks/511179303003127/
5.11E+14,451,0,0,0,4,0,34,489,234,723,67.63485477,32.36514523,tract_part,http://www.prisonersofthecensus.org/data/2010blocks/511179306001057/
5.11E+14,131,1,0,0,1,3,9,145,94,239,60.66945607,39.33054393,tract_part,http://www.prisonersofthecensus.org/data/2010blocks/511199510004067/
5.11E+14,7,1,0,0,0,0,1,9,75,84,10.71428571,89.28571429,tract_part,http://www.prisonersofthecensus.org/data/2010blocks/511210209001027/
5.11E+14,265,0,0,0,11,0,16,292,168,460,63.47826087,36.52173913,tract_part,http://www.prisonersofthecensus.org/data/2010blocks/511277003002060/
5.11E+14,101,0,0,0,0,0,10,111,43,154,72.07792208,27.92207792,tract_part,http://www.prisonersofthecensus.org/data/2010blocks/511319302003026/
5.11E+14,86,0,0,0,0,0,0,86,18,104,82.69230769,17.30769231,tract_part,http://www.prisonersofthecensus.org/data/2010blocks/511350003005080/
5.11E+14,892,1,2,1,2,0,17,915,356,1271,71.99055862,28.00944138,tract_part,http://www.prisonersofthecensus.org/data/2010blocks/511350003005078/
5.11E+14,140,0,0,0,7,5,11,163,223,386,42.22797927,57.77202073,tract_part,http://www.prisonersofthecensus.org/data/2010blocks/511371103001054/
5.11E+14,5,0,0,0,0,1,1,7,69,76,9.210526316,90.78947368,tract_part,http://www.prisonersofthecensus.org/data/2010blocks/511390302003009/
5.11E+14,7,0,0,0,0,0,0,7,24,31,22.58064516,77.41935484,tract_part,http://www.prisonersofthecensus.org/data/2010blocks/511410301005014/
5.11E+14,304,0,2,0,4,2,44,356,141,497,71.62977867,28.37022133,tract_part,http://www.prisonersofthecensus.org/data/2010blocks/511430105003170/
5.11E+14,62,0,0,0,0,0,1,63,56,119,52.94117647,47.05882353,tract_part,http://www.prisonersofthecensus.org/data/2010blocks/511430105002029/
5.11E+14,386,0,4,0,0,1,10,401,220,621,64.57326892,35.42673108,institutionalized,http://www.prisonersofthecensus.org/data/2010blocks/511455003001030/
5.11E+14,437,0,0,0,0,1,21,459,195,654,70.18348624,29.81651376,institutionalized,http://www.prisonersofthecensus.org/data/2010blocks/511455003001031/
5.11E+14,451,0,3,0,4,1,24,483,271,754,64.05835544,35.94164456,tract_part,http://www.prisonersofthecensus.org/data/2010blocks/511455003001043/
5.11E+14,486,2,2,1,9,3,29,532,205,737,72.18453189,27.81546811,tract_part,http://www.prisonersofthecensus.org/data/2010blocks/511479302011027/
5.11E+14,1925,57,22,4,15,49,321,2393,874,3267,73.24762779,26.75237221,institutionalized,http://www.prisonersofthecensus.org/data/2010blocks/511498501001005/
5.11E+14,710,12,2,1,37,31,89,882,436,1318,66.91957511,33.08042489,institutionalized,http://www.prisonersofthecensus.org/data/2010blocks/511498501001007/
5.11E+14,33,0,0,0,0,0,0,33,0,33,100,0,tract_part,http://www.prisonersofthecensus.org/data/2010blocks/511498505021041/
5.12E+14,377,1,6,0,16,3,159,562,291,853,65.88511137,34.11488863,tract_part,http://www.prisonersofthecensus.org/data/2010blocks/511539012321000/
5.12E+14,96,0,1,0,1,0,16,114,579,693,16.45021645,83.54978355,tract_part,http://www.prisonersofthecensus.org/data/2010blocks/511552106001064/
5.12E+14,6,0,0,0,1,0,1,8,20,28,28.57142857,71.42857143,tract_part,http://www.prisonersofthecensus.org/data/2010blocks/511579501002182/
5.12E+14,40,0,0,0,1,1,2,44,61,105,41.9047619,58.0952381,institutionalized,http://www.prisonersofthecensus.org/data/2010blocks/511590402001003/
5.12E+14,777,1,5,0,6,0,45,834,343,1177,70.85811385,29.14188615,institutionalized,http://www.prisonersofthecensus.org/data/2010blocks/511590402001004/
5.12E+14,228,0,8,0,2,0,63,301,85,386,77.97927461,22.02072539,tract_part,http://www.prisonersofthecensus.org/data/2010blocks/511590401003049/
5.12E+14,184,2,5,0,14,0,20,225,619,844,26.65876777,73.34123223,tract_part,http://www.prisonersofthecensus.org/data/2010blocks/511610305002064/
5.12E+14,14,0,0,0,0,0,2,16,73,89,17.97752809,82.02247191,tract_part,http://www.prisonersofthecensus.org/data/2010blocks/511639301003036/
5.12E+14,21,1,0,0,0,0,2,24,15,39,61.53846154,38.46153846,tract_part,http://www.prisonersofthecensus.org/data/2010blocks/511650114001009/
5.12E+14,24,0,0,0,0,0,0,24,64,88,27.27272727,72.72727273,tract_part,http://www.prisonersofthecensus.org/data/2010blocks/511650106001099/
5.12E+14,7,0,0,0,0,0,0,7,49,56,12.5,87.5,tract_part,http://www.prisonersofthecensus.org/data/2010blocks/511670302006017/
5.12E+14,16,0,1,0,0,0,0,17,87,104,16.34615385,83.65384615,tract,http://www.prisonersofthecensus.org/data/2010blocks/511670304022043/
5.12E+14,19,0,0,0,0,1,2,22,428,450,4.888888889,95.11111111,tract_part,http://www.prisonersofthecensus.org/data/2010blocks/511690302001005/
5.12E+14,21,0,0,0,1,1,6,29,63,92,31.52173913,68.47826087,tract_part,http://www.prisonersofthecensus.org/data/2010blocks/511710405002025/
5.12E+14,126,0,0,0,0,0,2,128,71,199,64.32160804,35.67839196,tract_part,http://www.prisonersofthecensus.org/data/2010blocks/511730305001038/
5.12E+14,688,1,0,0,0,0,6,695,455,1150,60.43478261,39.56521739,institutionalized,http://www.prisonersofthecensus.org/data/2010blocks/511752003001007/
5.12E+14,57,0,0,0,0,0,0,57,77,134,42.53731343,57.46268657,institutionalized,http://www.prisonersofthecensus.org/data/2010blocks/511752003001008/
5.12E+14,72,0,1,0,0,0,2,75,26,101,74.25742574,25.74257426,institutionalized,http://www.prisonersofthecensus.org/data/2010blocks/511752003001014/
5.12E+14,57,0,0,1,0,0,0,58,23,81,71.60493827,28.39506173,tract_part,http://www.prisonersofthecensus.org/data/2010blocks/511752004001172/
5.12E+14,472,0,7,0,12,0,23,514,809,1323,38.85109599,61.14890401,tract_part,http://www.prisonersofthecensus.org/data/2010blocks/511790102042000/
5.12E+14,55,0,0,0,0,1,0,56,25,81,69.13580247,30.86419753,tract_part,http://www.prisonersofthecensus.org/data/2010blocks/511790101061009/
5.12E+14,6,0,0,0,0,0,1,7,15,22,31.81818182,68.18181818,tract_part,http://www.prisonersofthecensus.org/data/2010blocks/511790102011248/
5.12E+14,67,1,0,0,0,0,0,68,19,87,78.16091954,21.83908046,tract_part,http://www.prisonersofthecensus.org/data/2010blocks/511838702012204/
5.12E+14,981,0,4,0,21,1,16,1023,267,1290,79.30232558,20.69767442,tract_part,http://www.prisonersofthecensus.org/data/2010blocks/511838702011029/
5.12E+14,834,1,3,0,9,2,22,871,224,1095,79.543379,20.456621,tract,http://www.prisonersofthecensus.org/data/2010blocks/511838702021002/
5.12E+14,451,1,4,0,4,2,30,492,538,1030,47.76699029,52.23300971,tract_part,http://www.prisonersofthecensus.org/data/2010blocks/511850201001002/
5.12E+14,21,0,0,0,2,1,2,26,102,128,20.3125,79.6875,tract_part,http://www.prisonersofthecensus.org/data/2010blocks/511870205003034/
5.12E+14,30,0,0,0,0,0,5,35,582,617,5.6726094,94.3273906,tract_part,http://www.prisonersofthecensus.org/data/2010blocks/511910105021000/
5.12E+14,562,0,2,1,7,3,13,588,197,785,74.9044586,25.0955414,tract_part,http://www.prisonersofthecensus.org/data/2010blocks/511959307003000/
5.12E+14,821,0,0,1,20,3,51,896,268,1164,76.97594502,23.02405498,tract_part,http://www.prisonersofthecensus.org/data/2010blocks/511959312002015/
5.12E+14,23,0,0,0,0,0,0,23,80,103,22.33009709,77.66990291,tract_part,http://www.prisonersofthecensus.org/data/2010blocks/511959315004007/
5.15E+14,211,4,12,1,13,22,109,372,60,432,86.11111111,13.88888889,tract,http://www.prisonersofthecensus.org/data/2010blocks/515102007021016/
5.15E+14,31,0,0,0,0,0,0,31,62,93,33.33333333,66.66666667,tract,http://www.prisonersofthecensus.org/data/2010blocks/515150501001030/
5.15E+14,31,0,0,0,0,0,2,33,91,124,26.61290323,73.38709677,tract,http://www.prisonersofthecensus.org/data/2010blocks/515200202004082/
5.16E+14,680,0,2,0,7,1,23,713,332,1045,68.22966507,31.77033493,tract,http://www.prisonersofthecensus.org/data/2010blocks/515500210052009/
5.16E+14,1185,0,7,0,4,0,22,1218,302,1520,80.13157895,19.86842105,tract,http://www.prisonersofthecensus.org/data/2010blocks/515500211023001/
5.16E+14,24,0,0,0,1,0,2,27,60,87,31.03448276,68.96551724,tract,http://www.prisonersofthecensus.org/data/2010blocks/515800602001011/
5.16E+14,171,0,0,0,1,2,4,178,66,244,72.95081967,27.04918033,tract,http://www.prisonersofthecensus.org/data/2010blocks/515900005002013/
5.16E+14,127,0,0,0,0,0,4,131,32,163,80.36809816,19.63190184,tract,http://www.prisonersofthecensus.org/data/2010blocks/515900013021065/
5.16E+14,1,0,0,0,0,0,0,1,1,2,50,50,tract,http://www.prisonersofthecensus.org/data/2010blocks/516200901003027/
5.17E+14,187,3,1,0,1,6,10,208,45,253,82.21343874,17.78656126,tract,http://www.prisonersofthecensus.org/data/2010blocks/516500106012023/
5.17E+14,76,0,1,0,0,0,22,99,207,306,32.35294118,67.64705882,tract,http://www.prisonersofthecensus.org/data/2010blocks/516600003024001/
5.17E+14,352,1,2,0,3,1,10,369,171,540,68.33333333,31.66666667,tract,http://www.prisonersofthecensus.org/data/2010blocks/516800006003012/
5.17E+14,24,0,0,0,1,0,1,26,17,43,60.46511628,39.53488372,tract,http://www.prisonersofthecensus.org/data/2010blocks/516900001001054/
5.17E+14,69,0,0,0,0,0,1,70,28,98,71.42857143,28.57142857,tract,http://www.prisonersofthecensus.org/data/2010blocks/516900003002019/
5.17E+14,350,0,0,0,0,0,12,362,82,444,81.53153153,18.46846847,institutionalized,http://www.prisonersofthecensus.org/data/2010blocks/517000301003047/
5.17E+14,56,0,1,0,0,0,0,57,32,89,64.04494382,35.95505618,institutionalized,http://www.prisonersofthecensus.org/data/2010blocks/517000301003048/
5.17E+14,66,1,1,0,0,4,5,77,15,92,83.69565217,16.30434783,tract,http://www.prisonersofthecensus.org/data/2010blocks/517000320023016/
5.17E+14,16,0,0,0,1,0,5,22,22,44,50,50,institutionalized,http://www.prisonersofthecensus.org/data/2010blocks/517100009011009/
5.17E+14,90,8,6,3,8,7,31,153,163,316,48.41772152,51.58227848,institutionalized,http://www.prisonersofthecensus.org/data/2010blocks/517100009011014/
5.17E+14,26,0,1,0,2,0,3,32,4,36,88.88888889,11.11111111,tract,http://www.prisonersofthecensus.org/data/2010blocks/517100036001021/
5.17E+14,1112,0,0,0,1,0,21,1134,227,1361,83.32108744,16.67891256,tract,http://www.prisonersofthecensus.org/data/2010blocks/517100049002011/
5.17E+14,157,1,1,0,2,2,6,169,9,178,94.94382022,5.056179775,tract,http://www.prisonersofthecensus.org/data/2010blocks/517308113001054/
5.17E+14,419,0,1,0,0,0,1,421,53,474,88.8185654,11.1814346,tract,http://www.prisonersofthecensus.org/data/2010blocks/517402109001031/
5.17E+14,868,1,31,13,200,19,241,1373,205,1578,87.00887199,12.99112801,tract,http://www.prisonersofthecensus.org/data/2010blocks/517402127011007/
5.18E+14,1283,4,0,0,2,6,52,1347,133,1480,91.01351351,8.986486486,tract,http://www.prisonersofthecensus.org/data/2010blocks/517600204005003/
5.18E+14,270,1,0,0,3,2,20,296,263,559,52.95169946,47.04830054,tract,http://www.prisonersofthecensus.org/data/2010blocks/517700011001035/
5.18E+14,22,0,0,0,2,1,4,29,89,118,24.57627119,75.42372881,tract,http://www.prisonersofthecensus.org/data/2010blocks/517750101003035/
5.18E+14,550,1,1,0,4,0,17,573,193,766,74.80417755,25.19582245,tract,http://www.prisonersofthecensus.org/data/2010blocks/518000754012001/
5.18E+14,805,1,3,0,3,0,21,833,530,1363,61.11518709,38.88481291,tract,http://www.prisonersofthecensus.org/data/2010blocks/518100454232045/
5.30E+14,0,1,0,0,13,0,21,35,6,41,85.36585366,14.63414634,tract_part,http://www.prisonersofthecensus.org/data/2010blocks/530019501003063/
5.30E+14,0,1,0,0,0,0,0,1,46,47,2.127659574,97.87234043,tract_part,http://www.prisonersofthecensus.org/data/2010blocks/530039603004026/
5.30E+14,55,9,6,0,1,10,155,236,436,672,35.11904762,64.88095238,tract_part,http://www.prisonersofthecensus.org/data/2010blocks/530050109014012/
5.30E+14,0,0,0,0,1,0,6,7,22,29,24.13793103,75.86206897,tract_part,http://www.prisonersofthecensus.org/data/2010blocks/530050113001073/
5.30E+14,0,0,0,0,0,0,1,1,1,2,50,50,tract_part,http://www.prisonersofthecensus.org/data/2010blocks/530079601002170/
5.30E+14,3,17,8,1,0,1,92,122,178,300,40.66666667,59.33333333,tract,http://www.prisonersofthecensus.org/data/2010blocks/530079610004001/
5.30E+14,0,5,0,0,0,0,0,5,0,5,100,0,tract_part,http://www.prisonersofthecensus.org/data/2010blocks/530099400001001/
5.30E+14,244,37,4,1,2,42,91,421,481,902,46.67405765,53.32594235,tract_part,http://www.prisonersofthecensus.org/data/2010blocks/530090002001051/
5.30E+14,3,0,0,0,0,0,1,4,23,27,14.81481481,85.18518519,tract_part,http://www.prisonersofthecensus.org/data/2010blocks/530090003002037/
5.30E+14,2,12,0,0,0,0,2,16,93,109,14.67889908,85.32110092,tract,http://www.prisonersofthecensus.org/data/2010blocks/530090010001006/
5.30E+14,39,13,0,0,0,10,12,74,146,220,33.63636364,66.36363636,tract_part,http://www.prisonersofthecensus.org/data/2010blocks/530110405041069/
5.30E+14,59,5,5,0,0,1,58,128,599,727,17.60660248,82.39339752,tract,http://www.prisonersofthecensus.org/data/2010blocks/530110424001005/
5.30E+14,0,0,0,0,0,1,1,2,6,8,25,75,tract_part,http://www.prisonersofthecensus.org/data/2010blocks/530139602002064/
5.30E+14,15,8,3,2,0,0,20,48,300,348,13.79310345,86.20689655,tract_part,http://www.prisonersofthecensus.org/data/2010blocks/530150021003008/
5.30E+14,0,2,0,0,0,0,0,2,22,24,8.333333333,91.66666667,tract_part,http://www.prisonersofthecensus.org/data/2010blocks/530199702003089/
5.30E+14,266,52,15,16,3,36,160,548,914,1462,37.48290014,62.51709986,tract_part,http://www.prisonersofthecensus.org/data/2010blocks/530210208003025/
5.30E+14,19,3,1,0,0,0,99,122,57,179,68.15642458,31.84357542,tract,http://www.prisonersofthecensus.org/data/2010blocks/530210202002026/
5.30E+14,4,0,1,0,4,0,26,35,23,58,60.34482759,39.65517241,institutionalized,http://www.prisonersofthecensus.org/data/2010blocks/530250104002100/
5.30E+14,11,6,0,0,15,3,80,115,90,205,56.09756098,43.90243902,institutionalized,http://www.prisonersofthecensus.org/data/2010blocks/530250104004016/
5.30E+14,1,1,0,0,0,0,1,3,20,23,13.04347826,86.95652174,tract_part,http://www.prisonersofthecensus.org/data/2010blocks/530270010004027/
5.30E+14,13,13,0,3,3,9,10,51,105,156,32.69230769,67.30769231,tract_part,http://www.prisonersofthecensus.org/data/2010blocks/530270004002013/
5.30E+14,0,3,0,0,0,0,0,3,0,3,100,0,tract_part,http://www.prisonersofthecensus.org/data/2010blocks/530279400001336/
5.30E+14,372,86,31,41,6,18,213,767,1209,1976,38.81578947,61.18421053,tract_part,http://www.prisonersofthecensus.org/data/2010blocks/530270016002013/
5.30E+14,4,0,0,1,0,5,3,13,36,49,26.53061224,73.46938776,tract_part,http://www.prisonersofthecensus.org/data/2010blocks/530299710001048/
5.30E+14,3,0,0,0,0,0,2,5,3,8,62.5,37.5,tract_part,http://www.prisonersofthecensus.org/data/2010blocks/530299707002003/
5.30E+14,0,4,0,0,0,0,2,6,37,43,13.95348837,86.04651163,tract_part,http://www.prisonersofthecensus.org/data/2010blocks/530319503001021/
5.30E+14,72,16,0,6,2,14,19,129,251,380,33.94736842,66.05263158,tract_part,http://www.prisonersofthecensus.org/data/2010blocks/530319507021027/
5.30E+14,2,2,0,0,1,0,1,6,12,18,33.33333333,66.66666667,institutionalized,http://www.prisonersofthecensus.org/data/2010blocks/530330314001021/
5.30E+14,0,0,0,0,0,0,0,0,4,4,0,100,institutionalized,http://www.prisonersofthecensus.org/data/2010blocks/530330314003016/
5.30E+14,7,8,1,0,0,1,2,19,12,31,61.29032258,38.70967742,tract_part,http://www.prisonersofthecensus.org/data/2010blocks/530330305012023/
5.30E+14,3,0,0,0,0,0,0,3,0,3,100,0,tract_part,http://www.prisonersofthecensus.org/data/2010blocks/530330304033002/
5.30E+14,234,17,38,0,0,2,89,380,277,657,57.83866058,42.16133942,tract,http://www.prisonersofthecensus.org/data/2010blocks/530330292031064/
5.30E+14,36,4,3,0,0,0,14,57,73,130,43.84615385,56.15384615,tract_part,http://www.prisonersofthecensus.org/data/2010blocks/530330297004000/
5.30E+14,116,50,41,5,163,64,338,777,250,1027,75.65725414,24.34274586,tract_part,http://www.prisonersofthecensus.org/data/2010blocks/530330288013002/
5.30E+14,4,0,1,0,1,0,0,6,6,12,50,50,tract,http://www.prisonersofthecensus.org/data/2010blocks/530330044002000/
5.30E+14,0,0,12,2,0,2,3,19,12,31,61.29032258,38.70967742,tract,http://www.prisonersofthecensus.org/data/2010blocks/530330052002008/
5.30E+14,0,0,1,0,0,0,1,2,3,5,40,60,tract,http://www.prisonersofthecensus.org/data/2010blocks/530330054004005/
5.30E+14,3,0,0,0,0,3,3,9,7,16,56.25,43.75,tract,http://www.prisonersofthecensus.org/data/2010blocks/530330074022004/
5.30E+14,12,0,1,0,0,0,0,13,10,23,56.52173913,43.47826087,tract,http://www.prisonersofthecensus.org/data/2010blocks/530330076002009/
5.30E+14,0,0,0,0,0,0,0,0,2,2,0,100,institutionalized,http://www.prisonersofthecensus.org/data/2010blocks/530330081001004/
5.30E+14,10,1,3,0,0,0,1,15,5,20,75,25,institutionalized,http://www.prisonersofthecensus.org/data/2010blocks/530330081002030/
5.30E+14,16,3,2,2,0,4,2,29,55,84,34.52380952,65.47619048,institutionalized,http://www.prisonersofthecensus.org/data/2010blocks/530330081002046/
5.30E+14,0,5,0,0,3,3,7,18,45,63,28.57142857,71.42857143,institutionalized,http://www.prisonersofthecensus.org/data/2010blocks/530330085001017/
5.30E+14,671,41,72,0,3,2,78,867,809,1676,51.73031026,48.26968974,institutionalized,http://www.prisonersofthecensus.org/data/2010blocks/530330085003006/
5.30E+14,12,1,4,1,0,0,1,19,28,47,40.42553191,59.57446809,tract,http://www.prisonersofthecensus.org/data/2010blocks/530330086003014/
5.30E+14,6,0,1,0,0,1,1,9,26,35,25.71428571,74.28571429,tract,http://www.prisonersofthecensus.org/data/2010blocks/530330094001002/
5.30E+14,0,0,0,1,0,0,0,1,0,1,100,0,tract,http://www.prisonersofthecensus.org/data/2010blocks/530330099001021/
5.30E+14,0,0,0,0,0,0,1,1,1,2,50,50,tract,http://www.prisonersofthecensus.org/data/2010blocks/530330323074000/
5.30E+14,1,0,2,0,0,1,1,5,12,17,29.41176471,70.58823529,tract_part,http://www.prisonersofthecensus.org/data/2010blocks/530330224005061/
5.30E+14,14,3,1,0,0,1,3,22,13,35,62.85714286,37.14285714,tract_part,http://www.prisonersofthecensus.org/data/2010blocks/530330253023010/
5.30E+14,0,0,5,0,0,0,0,5,0,5,100,0,tract,http://www.prisonersofthecensus.org/data/2010blocks/530330258062002/
5.30E+14,5,5,1,1,1,0,3,16,42,58,27.5862069,72.4137931,tract_part,http://www.prisonersofthecensus.org/data/2010blocks/530350921001017/
5.30E+14,64,25,0,0,1,4,18,112,246,358,31.2849162,68.7150838,tract_part,http://www.prisonersofthecensus.org/data/2010blocks/530350922001015/
5.30E+14,7,6,1,0,3,2,12,31,91,122,25.40983607,74.59016393,tract_part,http://www.prisonersofthecensus.org/data/2010blocks/530379756001036/
5.30E+14,1,5,0,0,1,0,1,8,18,26,30.76923077,69.23076923,tract_part,http://www.prisonersofthecensus.org/data/2010blocks/530399501006012/
5.30E+14,0,0,0,0,0,0,0,0,7,7,0,100,tract_part,http://www.prisonersofthecensus.org/data/2010blocks/530399503001018/
5.30E+14,4,8,3,0,3,6,19,43,125,168,25.5952381,74.4047619,tract_part,http://www.prisonersofthecensus.org/data/2010blocks/530419708004044/
5.30E+14,0,1,0,0,0,0,0,1,8,9,11.11111111,88.88888889,tract_part,http://www.prisonersofthecensus.org/data/2010blocks/530439601001003/
5.30E+14,0,0,0,0,0,0,0,0,4,4,0,100,tract_part,http://www.prisonersofthecensus.org/data/2010blocks/530439603003015/
5.30E+14,20,5,1,2,5,3,2,38,141,179,21.22905028,78.77094972,tract_part,http://www.prisonersofthecensus.org/data/2010blocks/530459604001012/
5.30E+14,2,9,0,1,5,4,11,32,74,106,30.18867925,69.81132075,tract_part,http://www.prisonersofthecensus.org/data/2010blocks/530459608003032/
5.30E+14,315,66,12,10,14,41,157,615,1076,1691,36.36901242,63.63098758,tract_part,http://www.prisonersofthecensus.org/data/2010blocks/530459606001008/
5.30E+14,0,3,0,0,0,0,0,3,2,5,60,40,tract_part,http://www.prisonersofthecensus.org/data/2010blocks/530479708003019/
5.30E+14,8,26,0,0,5,0,38,77,82,159,48.42767296,51.57232704,tract_part,http://www.prisonersofthecensus.org/data/2010blocks/530479707001055/
5.30E+14,0,0,0,0,0,0,0,0,1,1,0,100,tract_part,http://www.prisonersofthecensus.org/data/2010blocks/530479703003017/
5.31E+14,0,1,0,0,1,1,4,7,16,23,30.43478261,69.56521739,tract_part,http://www.prisonersofthecensus.org/data/2010blocks/530499503003028/
5.31E+14,1,3,0,0,0,0,0,4,21,25,16,84,tract_part,http://www.prisonersofthecensus.org/data/2010blocks/530519703003092/
5.31E+14,9,1,7,0,0,1,1,19,350,369,5.149051491,94.85094851,tract_part,http://www.prisonersofthecensus.org/data/2010blocks/530530702073009/
5.31E+14,144,48,6,5,9,18,53,283,564,847,33.4120425,66.5879575,tract_part,http://www.prisonersofthecensus.org/data/2010blocks/530530725042008/
5.31E+14,294,60,15,31,9,18,210,637,802,1439,44.26685198,55.73314802,tract_part,http://www.prisonersofthecensus.org/data/2010blocks/530530726035001/
5.31E+14,3,0,3,0,0,0,3,9,25,34,26.47058824,73.52941176,tract,http://www.prisonersofthecensus.org/data/2010blocks/530530734073031/
5.31E+14,104,46,32,9,120,42,631,984,403,1387,70.9444845,29.0555155,tract_part,http://www.prisonersofthecensus.org/data/2010blocks/530530602001088/
5.31E+14,16,2,1,0,1,8,9,37,38,75,49.33333333,50.66666667,tract,http://www.prisonersofthecensus.org/data/2010blocks/530530609061018/
5.31E+14,8,2,1,0,0,1,2,14,7,21,66.66666667,33.33333333,institutionalized,http://www.prisonersofthecensus.org/data/2010blocks/530530614001015/
5.31E+14,409,50,54,1,0,1,201,716,549,1265,56.60079051,43.39920949,institutionalized,http://www.prisonersofthecensus.org/data/2010blocks/530530614002000/
5.31E+14,0,0,0,0,0,0,0,0,2,2,0,100,tract,http://www.prisonersofthecensus.org/data/2010blocks/530530617002003/
5.31E+14,15,2,1,1,0,3,1,23,27,50,46,54,tract,http://www.prisonersofthecensus.org/data/2010blocks/530530618001019/
5.31E+14,1,1,0,0,0,2,4,8,8,16,50,50,tract,http://www.prisonersofthecensus.org/data/2010blocks/530530620003016/
5.31E+14,5,4,1,0,0,0,52,62,132,194,31.95876289,68.04123711,tract,http://www.prisonersofthecensus.org/data/2010blocks/530579525003030/
5.31E+14,0,1,0,0,0,0,2,3,22,25,12,88,tract_part,http://www.prisonersofthecensus.org/data/2010blocks/530599503002069/
5.31E+14,3,0,2,0,0,0,1,6,33,39,15.38461538,84.61538462,tract,http://www.prisonersofthecensus.org/data/2010blocks/530610517021007/
5.31E+14,170,53,22,1,32,4,106,388,827,1215,31.93415638,68.06584362,tract,http://www.prisonersofthecensus.org/data/2010blocks/530610407001018/
5.31E+14,0,0,0,0,0,0,0,0,4,4,0,100,tract_part,http://www.prisonersofthecensus.org/data/2010blocks/530610417011011/
5.31E+14,0,0,0,0,0,0,0,0,1,1,0,100,tract_part,http://www.prisonersofthecensus.org/data/2010blocks/530610528034002/
5.31E+14,0,3,1,0,1,1,4,10,24,34,29.41176471,70.58823529,tract_part,http://www.prisonersofthecensus.org/data/2010blocks/530610529053006/
5.31E+14,489,104,23,38,12,45,175,886,1594,2480,35.72580645,64.27419355,tract_part,http://www.prisonersofthecensus.org/data/2010blocks/530610522091002/
5.31E+14,320,95,17,23,12,26,239,732,1468,2200,33.27272727,66.72727273,tract_part,http://www.prisonersofthecensus.org/data/2010blocks/530630104011011/
5.31E+14,9,12,1,0,5,10,24,61,96,157,38.85350318,61.14649682,tract_part,http://www.prisonersofthecensus.org/data/2010blocks/530630139002073/
5.31E+14,43,34,6,0,13,28,89,213,276,489,43.55828221,56.44171779,tract,http://www.prisonersofthecensus.org/data/2010blocks/530630024001056/
5.31E+14,1,0,0,0,0,0,0,1,2,3,33.33333333,66.66666667,tract,http://www.prisonersofthecensus.org/data/2010blocks/530630026001025/
5.31E+14,0,2,0,0,0,1,0,3,15,18,16.66666667,83.33333333,tract,http://www.prisonersofthecensus.org/data/2010blocks/530630032002006/
5.31E+14,7,6,0,0,2,3,4,22,56,78,28.20512821,71.79487179,tract,http://www.prisonersofthecensus.org/data/2010blocks/530630035002070/
5.31E+14,7,16,0,0,3,13,7,46,123,169,27.21893491,72.78106509,tract,http://www.prisonersofthecensus.org/data/2010blocks/530630137001118/
5.31E+14,0,3,0,1,0,0,0,4,33,37,10.81081081,89.18918919,tract_part,http://www.prisonersofthecensus.org/data/2010blocks/530659503003046/
5.31E+14,4,1,0,0,1,2,2,10,14,24,41.66666667,58.33333333,tract_part,http://www.prisonersofthecensus.org/data/2010blocks/530670103003065/
5.31E+14,1,1,0,0,0,0,0,2,17,19,10.52631579,89.47368421,institutionalized,http://www.prisonersofthecensus.org/data/2010blocks/530670105202000/
5.31E+14,35,13,5,5,7,7,39,111,326,437,25.40045767,74.59954233,institutionalized,http://www.prisonersofthecensus.org/data/2010blocks/530670105204010/
5.31E+14,110,20,4,9,1,2,14,160,319,479,33.40292276,66.59707724,tract_part,http://www.prisonersofthecensus.org/data/2010blocks/530670127301022/
5.31E+14,0,0,0,0,0,0,0,0,6,6,0,100,tract_part,http://www.prisonersofthecensus.org/data/2010blocks/530699501004041/
5.31E+14,552,100,15,28,18,63,259,1035,1295,2330,44.42060086,55.57939914,tract_part,http://www.prisonersofthecensus.org/data/2010blocks/530719204001001/
5.31E+14,4,2,0,0,6,2,27,41,78,119,34.45378151,65.54621849,tract_part,http://www.prisonersofthecensus.org/data/2010blocks/530719206002017/
5.31E+14,27,73,4,0,0,0,29,133,295,428,31.07476636,68.92523364,tract,http://www.prisonersofthecensus.org/data/2010blocks/530730006001008/
5.31E+14,4,2,0,0,0,0,1,7,15,22,31.81818182,68.18181818,tract,http://www.prisonersofthecensus.org/data/2010blocks/530730010003006/
5.31E+14,0,2,1,0,2,2,10,17,25,42,40.47619048,59.52380952,tract_part,http://www.prisonersofthecensus.org/data/2010blocks/530750008001070/
5.31E+14,0,0,0,0,8,0,9,17,0,17,100,0,tract_part,http://www.prisonersofthecensus.org/data/2010blocks/530770019011043/
5.31E+14,1,10,0,0,0,0,58,69,7,76,90.78947368,9.210526316,tract_part,http://www.prisonersofthecensus.org/data/2010blocks/530770020013019/
5.31E+14,0,1,0,0,23,2,18,44,0,44,100,0,tract_part,http://www.prisonersofthecensus.org/data/2010blocks/530779400052023/
5.31E+14,2,18,0,1,5,6,13,45,27,72,62.5,37.5,tract_part,http://www.prisonersofthecensus.org/data/2010blocks/530779400041006/
5.31E+14,0,3,0,0,0,0,0,3,0,3,100,0,tract_part,http://www.prisonersofthecensus.org/data/2010blocks/530779400022091/
5.31E+14,79,65,7,0,131,5,301,588,264,852,69.01408451,30.98591549,institutionalized,http://www.prisonersofthecensus.org/data/2010blocks/530770001002036/
5.31E+14,6,8,0,0,6,1,17,38,27,65,58.46153846,41.53846154,institutionalized,http://www.prisonersofthecensus.org/data/2010blocks/530770001002069/
5.31E+14,52,21,13,1,13,3,35,138,151,289,47.75086505,52.24913495,tract,http://www.prisonersofthecensus.org/data/2010blocks/530770015011030/
5.31E+14,0,5,0,0,0,0,7,12,46,58,20.68965517,79.31034483,tract_part,http://www.prisonersofthecensus.org/data/2010blocks/530770028022001/
5.40E+14,14,0,0,1,0,0,0,15,107,122,12.29508197,87.70491803,tract_part,http://www.prisonersofthecensus.org/data/2010blocks/540039720006017/
5.40E+14,2,1,0,0,0,4,3,10,259,269,3.717472119,96.28252788,tract_part,http://www.prisonersofthecensus.org/data/2010blocks/540079679003096/
5.40E+14,8,0,0,0,0,0,0,8,59,67,11.94029851,88.05970149,tract_part,http://www.prisonersofthecensus.org/data/2010blocks/540110006001034/
5.40E+14,63,1,0,0,1,0,3,68,473,541,12.56931608,87.43068392,tract_part,http://www.prisonersofthecensus.org/data/2010blocks/540110104004051/
5.40E+14,83,0,0,0,1,2,3,89,480,569,15.64147627,84.35852373,tract_part,http://www.prisonersofthecensus.org/data/2010blocks/540179651002049/
5.40E+14,141,2,2,0,9,5,6,165,883,1048,15.74427481,84.25572519,tract_part,http://www.prisonersofthecensus.org/data/2010blocks/540190208001042/
5.40E+14,948,25,17,2,202,48,421,1663,367,2030,81.92118227,18.07881773,tract_part,http://www.prisonersofthecensus.org/data/2010blocks/540219677005052/
5.40E+14,41,2,0,1,2,3,3,52,164,216,24.07407407,75.92592593,tract_part,http://www.prisonersofthecensus.org/data/2010blocks/540259501001368/
5.40E+14,2,0,0,0,0,0,0,2,11,13,15.38461538,84.61538462,institutionalized,http://www.prisonersofthecensus.org/data/2010blocks/540279683003098/
5.40E+14,17,0,0,0,0,0,5,22,228,250,8.8,91.2,institutionalized,http://www.prisonersofthecensus.org/data/2010blocks/540279683003159/
5.40E+14,10,0,0,0,0,0,0,10,13,23,43.47826087,56.52173913,tract_part,http://www.prisonersofthecensus.org/data/2010blocks/540330304002032/
5.40E+14,10,0,0,0,1,0,1,12,55,67,17.91044776,82.08955224,tract_part,http://www.prisonersofthecensus.org/data/2010blocks/540390009001116/
5.40E+14,82,0,2,0,4,0,7,95,240,335,28.35820896,71.64179104,tract_part,http://www.prisonersofthecensus.org/data/2010blocks/540390123003056/
5.40E+14,15,0,0,0,0,0,0,15,32,47,31.91489362,68.08510638,tract_part,http://www.prisonersofthecensus.org/data/2010blocks/540390134001058/
5.40E+14,0,0,0,0,0,0,0,0,7,7,0,100,tract_part,http://www.prisonersofthecensus.org/data/2010blocks/540390107011008/
5.40E+14,19,0,0,0,1,4,5,29,229,258,11.24031008,88.75968992,tract_part,http://www.prisonersofthecensus.org/data/2010blocks/540459562001127/
5.40E+14,60,0,0,0,0,1,6,67,265,332,20.18072289,79.81927711,tract_part,http://www.prisonersofthecensus.org/data/2010blocks/540479545031038/
5.41E+14,24,0,0,0,0,0,0,24,228,252,9.523809524,90.47619048,tract_part,http://www.prisonersofthecensus.org/data/2010blocks/540510209002007/
5.41E+14,42,0,0,0,0,1,1,44,402,446,9.865470852,90.13452915,tract_part,http://www.prisonersofthecensus.org/data/2010blocks/540539548011141/
5.41E+14,619,1,8,0,3,2,61,694,584,1278,54.30359937,45.69640063,tract_part,http://www.prisonersofthecensus.org/data/2010blocks/540610110003087/
5.41E+14,3,0,0,0,0,0,2,5,61,66,7.575757576,92.42424242,tract,http://www.prisonersofthecensus.org/data/2010blocks/540690027001050/
5.41E+14,82,0,1,0,2,1,1,87,471,558,15.59139785,84.40860215,tract_part,http://www.prisonersofthecensus.org/data/2010blocks/540739621002105/
5.41E+14,29,3,0,0,5,4,7,48,203,251,19.12350598,80.87649402,tract_part,http://www.prisonersofthecensus.org/data/2010blocks/540759603002148/
5.41E+14,54,1,0,2,3,0,14,74,371,445,16.62921348,83.37078652,institutionalized,http://www.prisonersofthecensus.org/data/2010blocks/540779638001089/
5.41E+14,195,0,0,5,10,0,42,252,1280,1532,16.44908616,83.55091384,institutionalized,http://www.prisonersofthecensus.org/data/2010blocks/540779638001093/
5.41E+14,22,0,0,0,0,0,5,27,95,122,22.13114754,77.86885246,institutionalized,http://www.prisonersofthecensus.org/data/2010blocks/540779638001097/
5.41E+14,9,0,0,0,0,0,0,9,69,78,11.53846154,88.46153846,tract_part,http://www.prisonersofthecensus.org/data/2010blocks/540810004002024/
5.41E+14,1248,34,3,3,97,63,304,1752,635,2387,73.39757017,26.60242983,tract,http://www.prisonersofthecensus.org/data/2010blocks/540810008023062/
5.41E+14,142,7,1,0,5,7,14,176,307,483,36.4389234,63.5610766,tract_part,http://www.prisonersofthecensus.org/data/2010blocks/540810008043001/
5.41E+14,176,7,0,0,14,1,8,206,935,1141,18.0543383,81.9456617,tract_part,http://www.prisonersofthecensus.org/data/2010blocks/540839665001135/
5.41E+14,18,0,2,0,0,0,2,22,323,345,6.376811594,93.62318841,tract_part,http://www.prisonersofthecensus.org/data/2010blocks/540839659001018/
5.41E+14,421,9,11,0,26,31,95,593,580,1173,50.5541347,49.4458653,tract_part,http://www.prisonersofthecensus.org/data/2010blocks/540890006002059/
5.41E+14,47,4,0,0,3,0,2,56,315,371,15.09433962,84.90566038,tract_part,http://www.prisonersofthecensus.org/data/2010blocks/540919648002012/
5.50E+14,8,1,0,0,0,2,1,12,50,62,19.35483871,80.64516129,tract_part,http://www.prisonersofthecensus.org/data/2010blocks/550019504004085/
5.50E+14,523,59,21,1,157,43,329,1133,334,1467,77.23244717,22.76755283,tract_part,http://www.prisonersofthecensus.org/data/2010blocks/550019505021093/
5.50E+14,1,17,0,0,1,0,3,22,15,37,59.45945946,40.54054054,tract_part,http://www.prisonersofthecensus.org/data/2010blocks/550039508002081/
5.50E+14,3,9,0,0,0,2,2,16,108,124,12.90322581,87.09677419,tract_part,http://www.prisonersofthecensus.org/data/2010blocks/550050004002029/
5.50E+14,0,0,0,0,0,0,0,0,3,3,0,100,tract_part,http://www.prisonersofthecensus.org/data/2010blocks/550050006001064/
5.50E+14,6,18,0,0,0,0,2,26,22,48,54.16666667,45.83333333,tract_part,http://www.prisonersofthecensus.org/data/2010blocks/550079603002118/
5.50E+14,574,41,11,0,2,3,11,642,454,1096,58.57664234,41.42335766,tract,http://www.prisonersofthecensus.org/data/2010blocks/550090211001000/
5.50E+14,2,3,0,0,1,0,1,7,4,11,63.63636364,36.36363636,tract,http://www.prisonersofthecensus.org/data/2010blocks/550090003032003/
5.50E+14,36,37,4,0,18,0,18,113,151,264,42.8030303,57.1969697,tract,http://www.prisonersofthecensus.org/data/2010blocks/550090010001033/
5.50E+14,1,2,0,0,0,1,0,4,7,11,36.36363636,63.63636364,tract,http://www.prisonersofthecensus.org/data/2010blocks/550090017021001/
5.50E+14,119,75,10,0,83,0,83,370,162,532,69.54887218,30.45112782,tract,http://www.prisonersofthecensus.org/data/2010blocks/550090018013004/
5.50E+14,1,0,0,0,0,0,0,1,26,27,3.703703704,96.2962963,tract_part,http://www.prisonersofthecensus.org/data/2010blocks/550119603002003/
5.50E+14,1,10,0,0,0,0,0,11,18,29,37.93103448,62.06896552,tract_part,http://www.prisonersofthecensus.org/data/2010blocks/550139707002141/
5.50E+14,2,0,0,0,7,0,7,16,30,46,34.7826087,65.2173913,tract_part,http://www.prisonersofthecensus.org/data/2010blocks/550150205002009/
5.50E+14,4,3,0,0,0,2,2,11,130,141,7.80141844,92.19858156,tract_part,http://www.prisonersofthecensus.org/data/2010blocks/550170103001003/
5.50E+14,139,30,1,0,0,5,23,198,287,485,40.82474227,59.17525773,tract_part,http://www.prisonersofthecensus.org/data/2010blocks/550170105004110/
5.50E+14,571,49,15,7,0,2,82,726,789,1515,47.92079208,52.07920792,tract_part,http://www.prisonersofthecensus.org/data/2010blocks/550170108005058/
5.50E+14,4,0,1,0,0,0,5,10,64,74,13.51351351,86.48648649,tract_part,http://www.prisonersofthecensus.org/data/2010blocks/550199507003012/
5.50E+14,389,27,0,0,0,3,75,494,329,823,60.02430134,39.97569866,tract_part,http://www.prisonersofthecensus.org/data/2010blocks/550219704001012/
5.50E+14,40,3,0,0,0,1,18,62,154,216,28.7037037,71.2962963,tract_part,http://www.prisonersofthecensus.org/data/2010blocks/550219705002036/
5.50E+14,0,0,0,0,1,0,1,2,23,25,8,92,tract,http://www.prisonersofthecensus.org/data/2010blocks/550239605001034/
5.50E+14,220,10,0,0,0,3,20,253,261,514,49.22178988,50.77821012,tract_part,http://www.prisonersofthecensus.org/data/2010blocks/550239606001115/
5.50E+14,48,1,0,0,0,5,4,58,60,118,49.15254237,50.84745763,tract_part,http://www.prisonersofthecensus.org/data/2010blocks/550250119002088/
5.50E+14,308,12,0,0,0,6,29,355,324,679,52.28276878,47.71723122,remaining,http://www.prisonersofthecensus.org/data/2010blocks/550250125021008/
5.50E+14,58,0,0,0,0,0,5,63,55,118,53.38983051,46.61016949,institutionalized,http://www.prisonersofthecensus.org/data/2010blocks/550250125021017/
5.50E+14,7,1,0,0,0,1,3,12,4,16,75,25,tract_part,http://www.prisonersofthecensus.org/data/2010blocks/550250004081012/
5.50E+14,379,8,7,0,2,1,38,435,425,860,50.58139535,49.41860465,tract,http://www.prisonersofthecensus.org/data/2010blocks/550250017042004/
5.50E+14,4,0,0,0,0,0,0,4,11,15,26.66666667,73.33333333,tract_part,http://www.prisonersofthecensus.org/data/2010blocks/550250018041020/
5.50E+14,0,0,0,0,0,0,0,0,2,2,0,100,tract,http://www.prisonersofthecensus.org/data/2010blocks/550250019004016/
5.50E+14,4,0,0,0,0,0,0,4,5,9,44.44444444,55.55555556,tract_part,http://www.prisonersofthecensus.org/data/2010blocks/550250021004019/
5.50E+14,5,0,0,0,0,0,0,5,10,15,33.33333333,66.66666667,tract_part,http://www.prisonersofthecensus.org/data/2010blocks/550250024021019/
5.50E+14,9,0,0,0,1,2,1,13,6,19,68.42105263,31.57894737,tract_part,http://www.prisonersofthecensus.org/data/2010blocks/550250026023019/
5.50E+14,0,0,0,0,0,3,1,4,13,17,23.52941176,76.47058824,tract_part,http://www.prisonersofthecensus.org/data/2010blocks/550250028002001/
5.50E+14,579,35,0,8,0,1,0,623,730,1353,46.04582409,53.95417591,tract_part,http://www.prisonersofthecensus.org/data/2010blocks/550279605002035/
5.50E+14,93,2,21,0,0,1,204,321,178,499,64.32865731,35.67134269,tract_part,http://www.prisonersofthecensus.org/data/2010blocks/550279611003015/
5.50E+14,684,39,0,8,0,9,0,740,500,1240,59.67741935,40.32258065,institutionalized,http://www.prisonersofthecensus.org/data/2010blocks/550279603003014/
5.50E+14,649,50,0,11,1,10,0,721,887,1608,44.83830846,55.16169154,institutionalized,http://www.prisonersofthecensus.org/data/2010blocks/550279603004022/
5.50E+14,26,18,0,0,0,0,0,44,145,189,23.28042328,76.71957672,institutionalized,http://www.prisonersofthecensus.org/data/2010blocks/550279603004025/
5.50E+14,0,1,0,0,0,0,1,2,0,2,100,0,tract_part,http://www.prisonersofthecensus.org/data/2010blocks/550291007002032/
5.50E+14,8,4,1,0,4,1,11,29,51,80,36.25,63.75,tract_part,http://www.prisonersofthecensus.org/data/2010blocks/550291009002011/
5.50E+14,40,10,1,1,0,1,3,56,102,158,35.44303797,64.55696203,tract,http://www.prisonersofthecensus.org/data/2010blocks/550310203003025/
5.50E+14,46,2,1,0,0,0,0,49,38,87,56.32183908,43.67816092,tract_part,http://www.prisonersofthecensus.org/data/2010blocks/550310303003340/
5.50E+14,7,7,2,0,3,1,9,29,79,108,26.85185185,73.14814815,tract_part,http://www.prisonersofthecensus.org/data/2010blocks/550339705002020/
5.50E+14,0,0,0,0,0,0,0,0,26,26,0,100,tract_part,http://www.prisonersofthecensus.org/data/2010blocks/550339708001017/
5.50E+14,0,1,0,0,0,1,1,3,9,12,25,75,tract,http://www.prisonersofthecensus.org/data/2010blocks/550350005013021/
5.50E+14,3,1,0,0,0,0,0,4,10,14,28.57142857,71.42857143,tract_part,http://www.prisonersofthecensus.org/data/2010blocks/550350006001018/
5.50E+14,23,41,1,0,5,0,4,74,172,246,30.08130081,69.91869919,tract,http://www.prisonersofthecensus.org/data/2010blocks/550350011011025/
5.50E+14,0,0,0,0,0,0,0,0,11,11,0,100,tract,http://www.prisonersofthecensus.org/data/2010blocks/550350017002026/
5.50E+14,64,0,0,0,3,0,12,79,224,303,26.07260726,73.92739274,institutionalized,http://www.prisonersofthecensus.org/data/2010blocks/550390405002019/
5.50E+14,0,1,0,0,0,0,0,1,13,14,7.142857143,92.85714286,institutionalized,http://www.prisonersofthecensus.org/data/2010blocks/550390405002021/
5.50E+14,212,32,0,3,1,1,0,249,421,670,37.1641791,62.8358209,tract_part,http://www.prisonersofthecensus.org/data/2010blocks/550390420004046/
5.50E+14,4,37,0,0,1,2,4,48,32,80,60,40,tract_part,http://www.prisonersofthecensus.org/data/2010blocks/550419503002082/
5.50E+14,259,15,0,0,0,5,43,322,118,440,73.18181818,26.81818182,tract_part,http://www.prisonersofthecensus.org/data/2010blocks/550439602001051/
5.50E+14,2,0,0,0,0,1,2,5,38,43,11.62790698,88.37209302,tract_part,http://www.prisonersofthecensus.org/data/2010blocks/550439607002022/
5.50E+14,2,0,0,0,0,0,1,3,44,47,6.382978723,93.61702128,tract_part,http://www.prisonersofthecensus.org/data/2010blocks/550459604003006/
5.50E+14,2,0,1,0,1,1,5,10,26,36,27.77777778,72.22222222,tract_part,http://www.prisonersofthecensus.org/data/2010blocks/550471004004029/
5.51E+14,2,0,0,0,0,0,0,2,20,22,9.090909091,90.90909091,tract_part,http://www.prisonersofthecensus.org/data/2010blocks/550499504001022/
5.51E+14,0,0,0,0,0,0,0,0,10,10,0,100,tract_part,http://www.prisonersofthecensus.org/data/2010blocks/550511801001044/
5.51E+14,0,1,0,0,0,0,0,1,6,7,14.28571429,85.71428571,tract_part,http://www.prisonersofthecensus.org/data/2010blocks/550539605004035/
5.51E+14,1,16,0,0,0,0,1,18,20,38,47.36842105,52.63157895,institutionalized,http://www.prisonersofthecensus.org/data/2010blocks/550539605002023/
5.51E+14,0,0,0,0,0,0,0,0,3,3,0,100,institutionalized,http://www.prisonersofthecensus.org/data/2010blocks/550539605004017/
5.51E+14,318,54,0,9,0,5,70,456,544,1000,45.6,54.4,tract_part,http://www.prisonersofthecensus.org/data/2010blocks/550539601001362/
5.51E+14,25,3,0,0,0,0,12,40,60,100,40,60,tract_part,http://www.prisonersofthecensus.org/data/2010blocks/550539601001067/
5.51E+14,7,1,0,0,0,0,15,23,129,152,15.13157895,84.86842105,tract_part,http://www.prisonersofthecensus.org/data/2010blocks/550551011001023/
5.51E+14,15,7,0,0,0,0,4,26,45,71,36.61971831,63.38028169,tract_part,http://www.prisonersofthecensus.org/data/2010blocks/550571005001010/
5.51E+14,365,26,6,0,5,0,88,490,544,1034,47.38878143,52.61121857,tract_part,http://www.prisonersofthecensus.org/data/2010blocks/550571004004009/
5.51E+14,149,1,2,0,13,1,139,305,222,527,57.87476281,42.12523719,tract_part,http://www.prisonersofthecensus.org/data/2010blocks/550590006013029/
5.51E+14,110,0,1,0,5,1,25,142,104,246,57.72357724,42.27642276,tract_part,http://www.prisonersofthecensus.org/data/2010blocks/550590010001012/
5.51E+14,5,0,0,0,0,0,5,10,3,13,76.92307692,23.07692308,tract,http://www.prisonersofthecensus.org/data/2010blocks/550590011003019/
5.51E+14,6,0,0,0,0,2,2,10,3,13,76.92307692,23.07692308,tract,http://www.prisonersofthecensus.org/data/2010blocks/550590012001010/
5.51E+14,64,2,1,0,0,0,0,67,39,106,63.20754717,36.79245283,tract,http://www.prisonersofthecensus.org/data/2010blocks/550590016001001/
5.51E+14,2,2,0,0,3,0,4,11,14,25,44,56,tract_part,http://www.prisonersofthecensus.org/data/2010blocks/550619605002067/
5.51E+14,1,0,0,0,1,1,1,4,3,7,57.14285714,42.85714286,tract_part,http://www.prisonersofthecensus.org/data/2010blocks/550630001004043/
5.51E+14,2,0,0,0,0,0,1,3,21,24,12.5,87.5,institutionalized,http://www.prisonersofthecensus.org/data/2010blocks/550630003001049/
5.51E+14,37,3,5,0,0,0,6,51,122,173,29.47976879,70.52023121,institutionalized,http://www.prisonersofthecensus.org/data/2010blocks/550630003001054/
5.51E+14,1,0,0,0,0,0,1,2,22,24,8.333333333,91.66666667,tract_part,http://www.prisonersofthecensus.org/data/2010blocks/550659702004030/
5.51E+14,20,8,0,0,0,0,5,33,67,100,33,67,tract_part,http://www.prisonersofthecensus.org/data/2010blocks/550679606005010/
5.51E+14,4,0,0,0,0,0,0,4,2,6,66.66666667,33.33333333,tract_part,http://www.prisonersofthecensus.org/data/2010blocks/550679605001078/
5.51E+14,9,0,0,0,1,0,2,12,62,74,16.21621622,83.78378378,tract_part,http://www.prisonersofthecensus.org/data/2010blocks/550699609003030/
5.51E+14,1,1,0,0,1,0,1,4,5,9,44.44444444,55.55555556,tract_part,http://www.prisonersofthecensus.org/data/2010blocks/550710008001023/
5.51E+14,0,1,0,0,0,0,0,1,4,5,20,80,institutionalized,http://www.prisonersofthecensus.org/data/2010blocks/550730001002036/
5.51E+14,35,13,13,0,0,0,6,67,181,248,27.01612903,72.98387097,institutionalized,http://www.prisonersofthecensus.org/data/2010blocks/550730001003015/
5.51E+14,0,0,0,0,0,0,0,0,1,1,0,100,tract_part,http://www.prisonersofthecensus.org/data/2010blocks/550730011033005/
5.51E+14,3,4,0,0,1,4,2,14,114,128,10.9375,89.0625,tract_part,http://www.prisonersofthecensus.org/data/2010blocks/550759614005051/
5.51E+14,0,0,0,0,0,0,0,0,5,5,0,100,tract_part,http://www.prisonersofthecensus.org/data/2010blocks/550759607001216/
5.51E+14,4,1,0,0,0,0,1,6,33,39,15.38461538,84.61538462,tract_part,http://www.prisonersofthecensus.org/data/2010blocks/550779603001075/
5.51E+14,0,43,0,0,0,0,1,44,0,44,100,0,tract_part,http://www.prisonersofthecensus.org/data/2010blocks/550789401011097/
5.51E+14,3,0,5,0,6,1,8,23,50,73,31.50684932,68.49315068,tract_part,http://www.prisonersofthecensus.org/data/2010blocks/550791503012000/
5.51E+14,1254,3,6,0,0,5,109,1377,434,1811,76.03533959,23.96466041,tract,http://www.prisonersofthecensus.org/data/2010blocks/550791872002016/
5.51E+14,4,0,0,0,0,0,0,4,0,4,100,0,tract,http://www.prisonersofthecensus.org/data/2010blocks/550790007003008/
5.51E+14,8,0,0,0,0,0,0,8,0,8,100,0,tract,http://www.prisonersofthecensus.org/data/2010blocks/550790028002013/
5.51E+14,29,1,0,0,1,1,1,33,7,40,82.5,17.5,tract,http://www.prisonersofthecensus.org/data/2010blocks/550790064003005/
5.51E+14,51,4,0,0,0,0,0,55,43,98,56.12244898,43.87755102,tract,http://www.prisonersofthecensus.org/data/2010blocks/550790068001001/
5.51E+14,3,0,0,0,0,0,0,3,0,3,100,0,tract,http://www.prisonersofthecensus.org/data/2010blocks/550790070002003/
5.51E+14,83,0,1,1,0,0,0,85,19,104,81.73076923,18.26923077,tract,http://www.prisonersofthecensus.org/data/2010blocks/550790089002002/
5.51E+14,65,0,0,0,2,3,15,85,13,98,86.73469388,13.26530612,tract,http://www.prisonersofthecensus.org/data/2010blocks/550790092001002/
5.51E+14,16,1,0,0,0,0,2,19,5,24,79.16666667,20.83333333,tract,http://www.prisonersofthecensus.org/data/2010blocks/550790107002006/
5.51E+14,58,2,1,0,1,6,4,72,74,146,49.31506849,50.68493151,tract,http://www.prisonersofthecensus.org/data/2010blocks/550790110002004/
5.51E+14,13,0,0,0,0,0,2,15,3,18,83.33333333,16.66666667,tract,http://www.prisonersofthecensus.org/data/2010blocks/550791858002005/
5.51E+14,17,0,0,0,0,2,2,21,6,27,77.77777778,22.22222222,tract,http://www.prisonersofthecensus.org/data/2010blocks/550791860001002/
5.51E+14,4,1,0,0,0,3,1,9,6,15,60,40,tract,http://www.prisonersofthecensus.org/data/2010blocks/550791861002003/
5.51E+14,41,0,0,0,0,0,0,41,13,54,75.92592593,24.07407407,tract,http://www.prisonersofthecensus.org/data/2010blocks/550791862001010/
5.51E+14,706,14,1,0,1,4,18,744,280,1024,72.65625,27.34375,institutionalized,http://www.prisonersofthecensus.org/data/2010blocks/550791863001012/
5.51E+14,502,2,14,0,0,2,66,586,316,902,64.96674058,35.03325942,institutionalized,http://www.prisonersofthecensus.org/data/2010blocks/550791863001027/
5.51E+14,11,1,0,0,0,0,1,13,110,123,10.56910569,89.43089431,tract_part,http://www.prisonersofthecensus.org/data/2010blocks/550819503003012/
5.51E+14,20,2,1,0,0,0,0,23,34,57,40.35087719,59.64912281,tract_part,http://www.prisonersofthecensus.org/data/2010blocks/550831009002015/
5.51E+14,34,2,0,0,0,0,0,36,67,103,34.95145631,65.04854369,tract_part,http://www.prisonersofthecensus.org/data/2010blocks/550859709001024/
5.51E+14,0,0,0,0,0,0,0,0,4,4,0,100,tract_part,http://www.prisonersofthecensus.org/data/2010blocks/550859704003056/
5.51E+14,43,7,0,0,1,0,5,56,95,151,37.08609272,62.91390728,tract_part,http://www.prisonersofthecensus.org/data/2010blocks/550859715003029/
5.51E+14,0,0,0,0,1,0,1,2,10,12,16.66666667,83.33333333,tract_part,http://www.prisonersofthecensus.org/data/2010blocks/550859701011118/
5.51E+14,80,15,8,0,5,0,15,123,240,363,33.88429752,66.11570248,institutionalized,http://www.prisonersofthecensus.org/data/2010blocks/550870101001053/
5.51E+14,0,0,0,0,0,0,0,0,1,1,0,100,institutionalized,http://www.prisonersofthecensus.org/data/2010blocks/550870101002044/
5.51E+14,2,2,0,0,0,1,0,5,8,13,38.46153846,61.53846154,tract_part,http://www.prisonersofthecensus.org/data/2010blocks/550870110004026/
5.51E+14,49,6,0,0,0,1,4,60,65,125,48,52,tract_part,http://www.prisonersofthecensus.org/data/2010blocks/550879400001017/
5.51E+14,54,8,1,1,7,3,16,90,132,222,40.54054054,59.45945946,tract_part,http://www.prisonersofthecensus.org/data/2010blocks/550896302023024/
5.51E+14,1,0,0,0,0,0,0,1,28,29,3.448275862,96.55172414,tract_part,http://www.prisonersofthecensus.org/data/2010blocks/550919501003041/
5.51E+14,2,0,1,0,0,0,0,3,22,25,12,88,tract_part,http://www.prisonersofthecensus.org/data/2010blocks/550939607002033/
5.51E+14,2,6,0,0,1,3,0,12,59,71,16.90140845,83.09859155,tract_part,http://www.prisonersofthecensus.org/data/2010blocks/550959606001067/
5.51E+14,5,0,2,0,0,0,3,10,67,77,12.98701299,87.01298701,institutionalized,http://www.prisonersofthecensus.org/data/2010blocks/550979610002011/
5.51E+14,0,0,0,0,0,0,1,1,6,7,14.28571429,85.71428571,institutionalized,http://www.prisonersofthecensus.org/data/2010blocks/550979610002012/
5.51E+14,1,0,0,0,0,0,1,2,24,26,7.692307692,92.30769231,tract_part,http://www.prisonersofthecensus.org/data/2010blocks/550999705002027/
5.51E+14,62,18,0,1,1,1,6,89,186,275,32.36363636,67.63636364,tract,http://www.prisonersofthecensus.org/data/2010blocks/551019800001000/
5.51E+14,352,1,0,0,16,2,52,423,263,686,61.66180758,38.33819242,tract,http://www.prisonersofthecensus.org/data/2010blocks/551010002003004/
5.51E+14,1,0,0,0,0,0,0,1,3,4,25,75,tract_part,http://www.prisonersofthecensus.org/data/2010blocks/551010009013037/
5.51E+14,296,10,2,2,0,0,9,319,134,453,70.41942605,29.58057395,tract_part,http://www.prisonersofthecensus.org/data/2010blocks/551010012023008/
5.51E+14,0,1,0,0,0,0,1,2,3,5,40,60,tract_part,http://www.prisonersofthecensus.org/data/2010blocks/551010015042013/
5.51E+14,123,3,0,0,1,0,13,140,114,254,55.11811024,44.88188976,institutionalized,http://www.prisonersofthecensus.org/data/2010blocks/551010017025005/
5.51E+14,788,26,4,1,0,12,46,877,685,1562,56.14596671,43.85403329,institutionalized,http://www.prisonersofthecensus.org/data/2010blocks/551010017025009/
5.51E+14,0,0,0,0,1,1,3,5,18,23,21.73913043,78.26086957,tract_part,http://www.prisonersofthecensus.org/data/2010blocks/551039704003033/
5.51E+14,170,1,0,0,0,1,23,195,226,421,46.31828979,53.68171021,tract_part,http://www.prisonersofthecensus.org/data/2010blocks/551050012022057/
5.51E+14,39,2,1,0,0,0,2,44,37,81,54.32098765,45.67901235,tract_part,http://www.prisonersofthecensus.org/data/2010blocks/551050014002000/
5.51E+14,0,0,0,0,0,0,0,0,27,27,0,100,tract_part,http://www.prisonersofthecensus.org/data/2010blocks/551079605001082/
5.51E+14,10,13,2,0,2,0,4,31,72,103,30.09708738,69.90291262,tract_part,http://www.prisonersofthecensus.org/data/2010blocks/551091202011024/
5.51E+14,2,0,0,0,0,2,0,4,6,10,40,60,tract_part,http://www.prisonersofthecensus.org/data/2010blocks/551091209042001/
5.51E+14,41,3,0,1,0,2,4,51,68,119,42.85714286,57.14285714,tract_part,http://www.prisonersofthecensus.org/data/2010blocks/551091205013072/
5.51E+14,0,0,0,0,0,0,0,0,3,3,0,100,tract_part,http://www.prisonersofthecensus.org/data/2010blocks/551091205011022/
5.51E+14,44,18,1,0,0,0,17,80,158,238,33.61344538,66.38655462,tract_part,http://www.prisonersofthecensus.org/data/2010blocks/551110004021018/
5.51E+14,2,45,0,0,0,0,1,48,17,65,73.84615385,26.15384615,tract_part,http://www.prisonersofthecensus.org/data/2010blocks/551131003003035/
5.51E+14,0,6,0,0,0,0,1,7,12,19,36.84210526,63.15789474,tract_part,http://www.prisonersofthecensus.org/data/2010blocks/551139400001026/
5.51E+14,45,4,0,0,0,0,0,49,49,98,50,50,tract_part,http://www.prisonersofthecensus.org/data/2010blocks/551131008001210/
5.51E+14,0,0,0,0,3,0,14,17,0,17,100,0,tract_part,http://www.prisonersofthecensus.org/data/2010blocks/551151001002048/
5.51E+14,34,51,1,0,3,3,8,100,102,202,49.5049505,50.4950495,tract_part,http://www.prisonersofthecensus.org/data/2010blocks/551151004001031/
5.51E+14,505,32,0,10,1,3,0,551,616,1167,47.21508141,52.78491859,tract_part,http://www.prisonersofthecensus.org/data/2010blocks/551170111001025/
5.51E+14,50,4,2,1,12,2,24,95,142,237,40.08438819,59.91561181,tract_part,http://www.prisonersofthecensus.org/data/2010blocks/551170009003056/
5.51E+14,11,1,0,0,2,4,3,21,36,57,36.84210526,63.15789474,tract_part,http://www.prisonersofthecensus.org/data/2010blocks/551170114001030/
5.51E+14,1,1,0,0,0,0,0,2,49,51,3.921568627,96.07843137,tract_part,http://www.prisonersofthecensus.org/data/2010blocks/551199604003016/
5.51E+14,2,0,1,0,2,0,2,7,21,28,25,75,tract_part,http://www.prisonersofthecensus.org/data/2010blocks/551211004002145/
5.51E+14,7,0,0,0,0,0,4,11,58,69,15.94202899,84.05797101,tract_part,http://www.prisonersofthecensus.org/data/2010blocks/551239604001005/
5.51E+14,10,38,0,0,0,0,4,52,46,98,53.06122449,46.93877551,tract_part,http://www.prisonersofthecensus.org/data/2010blocks/551259505003026/
5.51E+14,18,2,0,0,24,12,53,109,249,358,30.44692737,69.55307263,tract_part,http://www.prisonersofthecensus.org/data/2010blocks/551270010004005/
5.51E+14,0,1,0,0,0,0,0,1,14,15,6.666666667,93.33333333,tract_part,http://www.prisonersofthecensus.org/data/2010blocks/551299506002065/
5.51E+14,7,5,2,0,4,9,13,40,164,204,19.60784314,80.39215686,tract_part,http://www.prisonersofthecensus.org/data/2010blocks/551314201052031/
5.51E+14,0,0,0,0,0,0,0,0,1,1,0,100,tract_part,http://www.prisonersofthecensus.org/data/2010blocks/551314202002006/
5.51E+14,1,0,0,0,0,0,0,1,11,12,8.333333333,91.66666667,tract_part,http://www.prisonersofthecensus.org/data/2010blocks/551332021012042/
5.51E+14,104,2,3,0,0,1,18,128,308,436,29.35779817,70.64220183,remaining,http://www.prisonersofthecensus.org/data/2010blocks/551332030001009/
5.51E+14,8,1,1,0,0,0,6,16,195,211,7.582938389,92.41706161,institutionalized,http://www.prisonersofthecensus.org/data/2010blocks/551332030002029/
5.51E+14,19,6,2,0,0,0,6,33,140,173,19.07514451,80.92485549,tract_part,http://www.prisonersofthecensus.org/data/2010blocks/551351010002001/
5.51E+14,380,28,0,6,0,3,0,417,609,1026,40.64327485,59.35672515,tract_part,http://www.prisonersofthecensus.org/data/2010blocks/551379607002034/
5.51E+14,11,3,0,0,0,0,0,14,98,112,12.5,87.5,tract_part,http://www.prisonersofthecensus.org/data/2010blocks/551379608002052/
5.51E+14,0,1,0,0,0,0,0,1,10,11,9.090909091,90.90909091,institutionalized,http://www.prisonersofthecensus.org/data/2010blocks/551390016001061/
5.51E+14,137,7,0,4,0,1,0,149,123,272,54.77941176,45.22058824,peter2,http://www.prisonersofthecensus.org/data/2010blocks/551390016002006/
5.51E+14,37,16,0,1,1,0,0,55,212,267,20.59925094,79.40074906,peter1,http://www.prisonersofthecensus.org/data/2010blocks/551390016002023/
5.51E+14,54,21,0,2,1,2,1,81,251,332,24.39759036,75.60240964,institutionalized,http://www.prisonersofthecensus.org/data/2010blocks/551390017004005/
5.51E+14,624,88,5,9,0,15,14,755,1267,2022,37.33926805,62.66073195,institutionalized,http://www.prisonersofthecensus.org/data/2010blocks/551390017004014/
5.51E+14,7,4,1,0,0,0,7,19,80,99,19.19191919,80.80808081,tract_part,http://www.prisonersofthecensus.org/data/2010blocks/551410110005020/
5.60E+14,1,11,0,0,6,3,15,36,18,54,66.66666667,33.33333333,tract_part,http://www.prisonersofthecensus.org/data/2010blocks/560039626002105/
5.60E+14,8,4,1,0,7,6,14,40,78,118,33.89830508,66.10169492,tract_part,http://www.prisonersofthecensus.org/data/2010blocks/560050005003019/
5.60E+14,34,43,4,2,1,14,106,204,456,660,30.90909091,69.09090909,tract_part,http://www.prisonersofthecensus.org/data/2010blocks/560079676002110/
5.60E+14,3,0,0,0,13,1,15,32,38,70,45.71428571,54.28571429,tract_part,http://www.prisonersofthecensus.org/data/2010blocks/560079677003042/
5.60E+14,0,1,0,0,2,0,7,10,22,32,31.25,68.75,tract_part,http://www.prisonersofthecensus.org/data/2010blocks/560099564001099/
5.60E+14,0,0,0,0,0,0,0,0,4,4,0,100,tract_part,http://www.prisonersofthecensus.org/data/2010blocks/560119503002066/
5.60E+14,1,52,0,0,8,5,17,83,82,165,50.3030303,49.6969697,tract_part,http://www.prisonersofthecensus.org/data/2010blocks/560130001001037/
5.60E+14,0,24,0,0,0,0,1,25,0,25,100,0,tract_part,http://www.prisonersofthecensus.org/data/2010blocks/560139401002019/
5.60E+14,3,10,0,0,14,7,33,67,162,229,29.25764192,70.74235808,tract_part,http://www.prisonersofthecensus.org/data/2010blocks/560139403001028/
5.60E+14,0,0,0,0,0,0,0,0,12,12,0,100,tract_part,http://www.prisonersofthecensus.org/data/2010blocks/560159580003662/
5.60E+14,21,9,0,1,24,6,68,129,397,526,24.52471483,75.47528517,institutionalized,http://www.prisonersofthecensus.org/data/2010blocks/560159579002004/
5.60E+14,2,5,0,0,9,2,14,32,38,70,45.71428571,54.28571429,institutionalized,http://www.prisonersofthecensus.org/data/2010blocks/560159579004024/
5.60E+14,0,1,0,0,0,0,0,1,7,8,12.5,87.5,tract_part,http://www.prisonersofthecensus.org/data/2010blocks/560179678001160/
5.60E+14,0,1,0,0,0,0,1,2,28,30,6.666666667,93.33333333,tract_part,http://www.prisonersofthecensus.org/data/2010blocks/560199552002041/
5.60E+14,22,3,0,0,0,0,35,60,125,185,32.43243243,67.56756757,institutionalized,http://www.prisonersofthecensus.org/data/2010blocks/560210007001093/
5.60E+14,5,2,0,0,0,2,14,23,62,85,27.05882353,72.94117647,institutionalized,http://www.prisonersofthecensus.org/data/2010blocks/560210007001123/
5.60E+14,0,0,0,0,1,1,1,3,15,18,16.66666667,83.33333333,tract_part,http://www.prisonersofthecensus.org/data/2010blocks/560239784002050/
5.60E+14,16,11,0,2,0,0,53,82,189,271,30.25830258,69.74169742,tract_part,http://www.prisonersofthecensus.org/data/2010blocks/560250012001004/
5.60E+14,7,64,1,0,8,6,19,105,161,266,39.47368421,60.52631579,tract_part,http://www.prisonersofthecensus.org/data/2010blocks/560250018003416/
5.60E+14,0,0,0,0,0,1,0,1,11,12,8.333333333,91.66666667,tract_part,http://www.prisonersofthecensus.org/data/2010blocks/560279572003055/
5.60E+14,1,11,1,0,2,9,19,43,165,208,20.67307692,79.32692308,tract_part,http://www.prisonersofthecensus.org/data/2010blocks/560279572002016/
5.60E+14,0,2,0,0,0,0,0,2,53,55,3.636363636,96.36363636,tract_part,http://www.prisonersofthecensus.org/data/2010blocks/560299654001017/
5.60E+14,1,3,0,0,2,5,18,29,38,67,43.28358209,56.71641791,tract_part,http://www.prisonersofthecensus.org/data/2010blocks/560319594006074/
5.60E+14,4,6,1,0,4,4,9,28,74,102,27.45098039,72.54901961,tract_part,http://www.prisonersofthecensus.org/data/2010blocks/560330004001037/
5.60E+14,1,0,0,0,0,0,2,3,15,18,16.66666667,83.33333333,tract_part,http://www.prisonersofthecensus.org/data/2010blocks/560350001021146/
5.60E+14,6,13,0,0,7,3,27,56,87,143,39.16083916,60.83916084,tract_part,http://www.prisonersofthecensus.org/data/2010blocks/560379706011021/
5.60E+14,0,1,0,0,2,1,2,6,39,45,13.33333333,86.66666667,tract_part,http://www.prisonersofthecensus.org/data/2010blocks/560419754001023/
5.60E+14,0,0,0,0,0,0,2,2,8,10,20,80,tract,http://www.prisonersofthecensus.org/data/2010blocks/560430003013028/
5.60E+14,10,17,1,1,11,6,39,85,185,270,31.48148148,68.51851852,tract_part,http://www.prisonersofthecensus.org/data/2010blocks/560459511002984/
5.60E+14,0,2,0,0,0,0,1,3,6,9,33.33333333,66.66666667,tract_part,http://www.prisonersofthecensus.org/data/2010blocks/560459513002033/